Year,Student_ID,Gender,State,Assignment,Midterm1,Midterm2,Quiz,Total CourseWorkmarks,Final Marks,Total Marks,Grade
2019,1,Female,Pahang,20,8,7,4,39,28,67,B
2016,2,Male,Kedah,18,4,7,3,32,24,56,C
2012,3,Male,Malacca,18,7,7,2,34,29,63,B
2016,4,Female,Kelantan,15,7,5,1,28,31,59,C
2019,5,Male,Perak,17,3,7,3,30,29,59,C
2017,6,Male,Johor,18,9,10,2,39,33,72,B
2012,7,Female,Negeri Sembilan,13,6,6,3,28,27,55,C
2016,8,Female,Sarawak,16,8,8,4,36,28,64,B
2017,9,Female,Negeri Sembilan,19,3,7,5,34,24,58,C
2018,10,Male,Terengganu,20,6,3,1,30,25,55,C
2012,11,Male,Malacca,17,6,7,2,32,39,71,B
2018,12,Female,Pahang,18,5,8,2,33,34,67,B
2017,13,Male,Sabah,16,7,7,5,35,38,73,B
2016,14,Male,Negeri Sembilan,21,10,3,4,38,30,68,B
2014,15,Male,Sabah,13,8,9,3,33,23,56,C
2016,16,Male,Johor,14,10,5,3,32,37,69,B
2015,17,Male,Pahang,20,9,7,4,40,29,69,B
2019,18,Male,Sarawak,14,6,10,5,35,28,63,B
2017,19,Female,Perak,14,9,9,3,35,33,68,B
2017,20,Female,Selangor,20,4,5,3,32,34,66,B
2017,21,Female,Malacca,21,8,8,2,39,40,79,A
2017,22,Male,Perak,15,9,4,4,32,31,63,B
2017,23,Female,Sarawak,18,7,7,4,36,38,74,B
2018,24,Female,Sabah,17,5,6,3,31,28,59,C
2019,25,Male,Negeri Sembilan,17,6,4,5,32,30,62,B
2013,26,Male,Perak,20,10,6,4,40,38,78,B
2018,27,Male,Sabah,17,4,9,2,32,32,64,B
2015,28,Female,Selangor,17,10,6,2,35,37,72,B
2017,29,Male,Terengganu,14,9,3,5,31,23,54,C
2019,30,Male,Perak,14,9,9,4,36,28,64,B
2017,31,Male,Johor,17,6,7,1,31,28,59,C
2013,32,Female,Sabah,13,3,3,1,20,31,51,C
2012,33,Female,Perak,13,4,6,5,28,33,61,B
2012,34,Female,Kelantan,21,9,8,4,42,32,74,B
2016,35,Male,Malacca,19,5,10,1,35,39,74,B
2016,36,Male,Selangor,14,8,3,5,30,35,65,B
2019,37,Female,Negeri Sembilan,17,9,8,3,37,33,70,B
2016,38,Female,Selangor,21,7,9,4,41,38,79,A
2015,39,Female,Malacca,20,10,6,1,37,35,72,B
2014,40,Male,Perlis,13,9,5,3,30,22,52,C
2013,41,Male,Negeri Sembilan,13,7,4,2,26,25,51,C
2013,42,Male,Selangor,20,4,8,2,34,24,58,C
2019,43,Male,Sarawak,19,7,9,2,37,37,74,B
2019,44,Male,Kelantan,19,10,6,2,37,32,69,B
2019,45,Male,Selangor,16,8,7,5,36,24,60,B
2014,46,Male,Pahang,15,10,8,1,34,22,56,C
2016,47,Male,Kelantan,13,10,5,1,29,30,59,C
2019,48,Male,Pahang,18,5,4,5,32,26,58,C
2013,49,Male,Kedah,19,4,6,3,32,25,57,C
2014,50,Male,Sabah,15,5,7,4,31,38,69,B
2016,51,Male,Malacca,18,5,4,2,29,30,59,C
2013,52,Female,Perak,21,6,4,2,33,37,70,B
2013,53,Male,Kelantan,20,7,4,2,33,28,61,B
2016,54,Female,Pahang,14,7,5,4,30,22,52,C
2019,55,Male,Johor,16,4,8,3,31,23,54,C
2014,56,Male,Sarawak,14,7,6,4,31,25,56,C
2013,57,Male,Selangor,17,3,4,4,28,36,64,B
2014,58,Female,Pahang,18,3,8,1,30,40,70,B
2012,59,Female,Pahang,13,4,7,2,26,24,50,C
2014,60,Male,Malacca,16,10,10,3,39,32,71,B
2012,61,Female,Terengganu,16,8,3,2,29,28,57,C
2015,62,Male,Penang,21,8,4,5,38,25,63,B
2016,63,Male,Perlis,20,9,6,4,39,29,68,B
2014,64,Female,Sarawak,13,9,9,2,33,27,60,B
2015,65,Male,Selangor,20,10,6,4,40,22,62,B
2012,66,Female,Perak,19,8,3,4,34,29,63,B
2018,67,Female,Sabah,18,9,3,1,31,30,61,B
2012,68,Male,Perlis,16,6,5,4,31,33,64,B
2013,69,Female,Penang,20,6,5,2,33,22,55,C
2015,70,Female,Kedah,16,10,8,5,39,31,70,B
2017,71,Male,Sarawak,17,9,5,2,33,38,71,B
2015,72,Female,Perlis,15,10,6,1,32,32,64,B
2018,73,Female,Selangor,13,3,3,2,21,32,53,C
2012,74,Male,Sarawak,17,4,9,3,33,26,59,C
2013,75,Female,Selangor,14,8,3,5,30,22,52,C
2014,76,Female,Perlis,21,10,8,3,42,22,64,B
2018,77,Male,Kelantan,15,9,7,5,36,29,65,B
2014,78,Male,Pahang,21,7,6,4,38,36,74,B
2016,79,Male,Malacca,13,4,7,3,27,33,60,B
2017,80,Male,Malacca,17,10,3,3,33,38,71,B
2015,81,Male,Malacca,19,4,7,1,31,34,65,B
2018,82,Female,Kelantan,13,6,4,4,27,22,49,F
2013,83,Female,Sarawak,19,9,3,2,33,40,73,B
2017,84,Female,Pahang,13,6,9,1,29,32,61,B
2016,85,Male,Terengganu,20,5,3,2,30,37,67,B
2014,86,Male,Perlis,21,10,5,2,38,25,63,B
2019,87,Female,Johor,17,3,6,3,29,30,59,C
2012,88,Female,Perlis,16,4,8,2,30,37,67,B
2017,89,Female,Kelantan,20,9,8,2,39,28,67,B
2019,90,Male,Kelantan,21,10,6,3,40,22,62,B
2012,91,Male,Perak,21,8,6,2,37,39,76,B
2015,92,Female,Penang,18,5,5,1,29,34,63,B
2016,93,Male,Perak,14,5,10,2,31,38,69,B
2017,94,Female,Perak,20,9,3,4,36,40,76,B
2018,95,Male,Johor,15,8,10,2,35,26,61,B
2012,96,Female,Perak,14,4,7,3,28,22,50,C
2012,97,Female,Sabah,18,10,9,4,41,28,69,B
2016,98,Male,Perak,14,10,9,3,36,22,58,C
2015,99,Male,Perlis,15,4,6,2,27,30,57,C
2014,100,Male,Terengganu,19,8,8,5,40,34,74,B
2018,101,Male,Malacca,13,8,5,4,30,35,65,B
2015,102,Female,Sarawak,19,9,10,5,43,34,77,B
2012,103,Male,Johor,16,4,6,5,31,38,69,B
2016,104,Male,Selangor,18,8,3,3,32,30,62,B
2016,105,Female,Malacca,13,5,5,4,27,35,62,B
2019,106,Female,Johor,21,5,3,1,30,23,53,C
2018,107,Female,Sarawak,13,5,10,3,31,28,59,C
2013,108,Male,Terengganu,18,8,10,3,39,31,70,B
2017,109,Female,Negeri Sembilan,19,3,5,4,31,33,64,B
2013,110,Female,Perlis,19,8,5,1,33,24,57,C
2015,111,Male,Pahang,17,9,3,3,32,34,66,B
2014,112,Male,Johor,21,3,8,1,33,40,73,B
2012,113,Male,Perlis,19,3,7,3,32,34,66,B
2014,114,Male,Sarawak,18,3,7,4,32,25,57,C
2012,115,Male,Malacca,17,4,5,4,30,40,70,B
2014,116,Female,Sabah,13,5,8,5,31,36,67,B
2017,117,Male,Malacca,20,4,8,5,37,38,75,B
2018,118,Female,Johor,21,8,7,3,39,33,72,B
2017,119,Female,Johor,21,6,9,3,39,40,79,A
2015,120,Male,Kelantan,21,7,10,2,40,34,74,B
2015,121,Female,Penang,16,6,5,4,31,26,57,C
2013,122,Male,Kelantan,13,8,10,1,32,23,55,C
2014,123,Male,Penang,19,8,5,2,34,28,62,B
2015,124,Female,Sarawak,13,9,6,4,32,40,72,B
2018,125,Female,Johor,13,8,5,2,28,40,68,B
2014,126,Male,Sarawak,20,4,4,1,29,32,61,B
2013,127,Male,Johor,19,6,6,5,36,23,59,C
2015,128,Male,Johor,14,7,3,5,29,29,58,C
2016,129,Female,Selangor,14,4,5,4,27,26,53,C
2018,130,Male,Terengganu,19,4,9,2,34,38,72,B
2019,131,Female,Pahang,14,9,3,3,29,35,64,B
2014,132,Female,Pahang,18,7,3,4,32,36,68,B
2017,133,Male,Negeri Sembilan,16,7,7,1,31,32,63,B
2014,134,Female,Sabah,14,4,4,3,25,31,56,C
2013,135,Male,Malacca,18,5,3,4,30,26,56,C
2014,136,Male,Penang,18,5,6,1,30,22,52,C
2019,137,Male,Kedah,19,6,8,4,37,23,60,B
2019,138,Male,Sabah,18,7,9,2,36,23,59,C
2017,139,Female,Terengganu,20,6,9,5,40,24,64,B
2015,140,Male,Perlis,18,5,4,2,29,40,69,B
2013,141,Male,Terengganu,14,7,9,5,35,23,58,C
2012,142,Male,Kelantan,14,3,3,2,22,25,47,F
2018,143,Female,Perak,20,10,10,3,43,24,67,B
2016,144,Male,Malacca,15,6,6,4,31,29,60,B
2012,145,Female,Perlis,20,3,5,5,33,26,59,C
2017,146,Male,Negeri Sembilan,13,4,8,1,26,37,63,B
2018,147,Female,Perlis,18,8,10,1,37,24,61,B
2013,148,Female,Sabah,13,8,5,4,30,39,69,B
2013,149,Male,Selangor,15,9,5,2,31,23,54,C
2018,150,Male,Kelantan,13,4,10,3,30,24,54,C
2014,151,Male,Perak,14,8,5,5,32,29,61,B
2013,152,Male,Johor,21,10,3,1,35,25,60,B
2014,153,Female,Perlis,18,10,10,4,42,28,70,B
2013,154,Male,Sabah,17,9,8,3,37,29,66,B
2016,155,Male,Kelantan,21,6,5,5,37,23,60,B
2019,156,Female,Selangor,18,7,5,3,33,33,66,B
2013,157,Male,Terengganu,16,7,9,1,33,40,73,B
2014,158,Female,Negeri Sembilan,19,3,8,3,33,40,73,B
2015,159,Female,Terengganu,21,4,4,2,31,33,64,B
2015,160,Female,Negeri Sembilan,14,9,3,2,28,33,61,B
2016,161,Male,Penang,18,4,5,2,29,33,62,B
2015,162,Male,Selangor,16,10,5,4,35,34,69,B
2019,163,Female,Kedah,21,7,6,1,35,31,66,B
2018,164,Female,Perak,17,4,6,5,32,34,66,B
2017,165,Female,Terengganu,13,4,4,3,24,39,63,B
2013,166,Male,Negeri Sembilan,14,9,4,2,29,39,68,B
2016,167,Female,Negeri Sembilan,15,4,3,2,24,34,58,C
2018,168,Female,Pahang,21,10,4,4,39,30,69,B
2018,169,Male,Negeri Sembilan,20,10,4,3,37,31,68,B
2019,170,Male,Terengganu,21,10,5,4,40,28,68,B
2017,171,Female,Penang,21,4,10,4,39,28,67,B
2019,172,Female,Johor,14,10,3,2,29,23,52,C
2014,173,Female,Pahang,17,4,8,1,30,35,65,B
2013,174,Female,Selangor,14,3,5,3,25,23,48,F
2019,175,Female,Johor,18,10,4,5,37,37,74,B
2016,176,Male,Johor,19,10,7,4,40,35,75,B
2014,177,Female,Malacca,20,8,8,3,39,35,74,B
2019,178,Male,Terengganu,16,8,5,3,32,24,56,C
2015,179,Female,Perak,14,10,9,4,37,35,72,B
2012,180,Female,Penang,14,3,5,1,23,35,58,C
2013,181,Female,Sarawak,13,7,4,2,26,29,55,C
2013,182,Male,Kedah,21,9,7,2,39,37,76,B
2018,183,Female,Johor,17,6,3,4,30,29,59,C
2013,184,Male,Johor,17,4,7,2,30,22,52,C
2012,185,Male,Sabah,19,6,8,5,38,28,66,B
2014,186,Male,Negeri Sembilan,16,7,10,4,37,25,62,B
2018,187,Female,Perlis,19,8,5,4,36,28,64,B
2012,188,Female,Negeri Sembilan,20,7,10,5,42,36,78,B
2017,189,Male,Penang,21,7,9,4,41,24,65,B
2018,190,Male,Negeri Sembilan,20,4,8,3,35,36,71,B
2017,191,Male,Kedah,13,8,8,4,33,37,70,B
2018,192,Female,Pahang,19,10,9,3,41,31,72,B
2018,193,Male,Sarawak,13,5,7,5,30,39,69,B
2016,194,Female,Perak,20,3,9,2,34,39,73,B
2017,195,Male,Pahang,15,6,10,4,35,34,69,B
2015,196,Female,Selangor,21,5,9,1,36,40,76,B
2017,197,Female,Terengganu,20,8,6,1,35,40,75,B
2019,198,Female,Perlis,17,5,9,2,33,24,57,C
2017,199,Female,Kedah,13,3,3,3,22,36,58,C
2016,200,Female,Pahang,18,5,3,3,29,34,63,B
2019,201,Female,Sabah,13,6,4,1,24,32,56,C
2017,202,Female,Terengganu,21,10,5,1,37,36,73,B
2013,203,Male,Malacca,17,7,8,3,35,39,74,B
2014,204,Female,Negeri Sembilan,14,5,7,3,29,39,68,B
2014,205,Female,Negeri Sembilan,19,3,6,3,31,38,69,B
2013,206,Male,Terengganu,20,7,6,4,37,38,75,B
2017,207,Female,Sarawak,19,9,3,3,34,36,70,B
2013,208,Male,Malacca,15,4,9,1,29,31,60,B
2018,209,Female,Perlis,19,3,4,1,27,35,62,B
2016,210,Male,Sarawak,16,10,3,5,34,38,72,B
2013,211,Female,Malacca,15,8,9,4,36,31,67,B
2016,212,Male,Pahang,21,3,4,4,32,28,60,B
2012,213,Female,Terengganu,16,3,4,5,28,23,51,C
2016,214,Male,Johor,15,7,6,2,30,32,62,B
2013,215,Female,Johor,13,3,10,5,31,24,55,C
2015,216,Male,Perlis,21,8,4,5,38,36,74,B
2015,217,Female,Johor,20,5,8,3,36,23,59,C
2013,218,Male,Kelantan,21,10,10,2,43,34,77,B
2015,219,Female,Terengganu,17,7,5,2,31,30,61,B
2016,220,Male,Penang,18,8,10,5,41,25,66,B
2019,221,Male,Selangor,19,7,8,2,36,37,73,B
2019,222,Male,Kelantan,14,9,4,1,28,35,63,B
2014,223,Female,Selangor,20,7,3,2,32,37,69,B
2013,224,Female,Pahang,18,7,10,4,39,22,61,B
2015,225,Male,Sarawak,16,4,10,5,35,24,59,C
2014,226,Female,Johor,16,6,6,4,32,37,69,B
2015,227,Female,Kelantan,21,8,5,3,37,37,74,B
2014,228,Male,Johor,14,9,10,1,34,28,62,B
2015,229,Male,Penang,19,10,6,3,38,39,77,B
2018,230,Male,Selangor,17,7,4,3,31,24,55,C
2018,231,Female,Sarawak,18,8,3,2,31,39,70,B
2014,232,Male,Perlis,14,8,3,4,29,25,54,C
2012,233,Female,Sarawak,19,10,3,1,33,25,58,C
2019,234,Female,Sarawak,18,7,5,1,31,35,66,B
2014,235,Female,Malacca,19,10,7,3,39,23,62,B
2018,236,Female,Johor,18,6,9,1,34,37,71,B
2018,237,Male,Kedah,14,4,4,1,23,30,53,C
2014,238,Female,Malacca,21,9,7,2,39,33,72,B
2016,239,Male,Perak,15,10,7,5,37,36,73,B
2013,240,Male,Terengganu,19,7,3,4,33,27,60,B
2013,241,Male,Sarawak,20,4,8,5,37,36,73,B
2015,242,Female,Johor,17,10,7,1,35,37,72,B
2017,243,Male,Sabah,19,10,7,5,41,34,75,B
2018,244,Male,Perlis,17,7,4,1,29,37,66,B
2012,245,Female,Penang,16,10,9,3,38,32,70,B
2019,246,Male,Sarawak,14,3,6,3,26,23,49,F
2013,247,Female,Perlis,21,4,6,1,32,32,64,B
2016,248,Male,Johor,17,6,6,1,30,22,52,C
2012,249,Male,Johor,17,7,9,3,36,35,71,B
2016,250,Female,Perlis,18,9,3,2,32,30,62,B
2012,251,Male,Johor,20,4,10,4,38,34,72,B
2019,252,Female,Negeri Sembilan,14,5,10,4,33,34,67,B
2017,253,Female,Sabah,20,8,4,3,35,33,68,B
2012,254,Male,Johor,20,9,7,5,41,26,67,B
2019,255,Female,Kelantan,17,8,6,4,35,39,74,B
2013,256,Female,Perlis,19,8,10,4,41,23,64,B
2012,257,Female,Malacca,18,10,5,2,35,39,74,B
2014,258,Female,Pahang,14,5,7,2,28,32,60,B
2018,259,Male,Terengganu,21,7,5,4,37,30,67,B
2014,260,Female,Perlis,13,5,9,2,29,25,54,C
2018,261,Male,Penang,13,8,3,5,29,32,61,B
2015,262,Male,Selangor,15,6,3,3,27,28,55,C
2018,263,Male,Perak,18,7,7,4,36,35,71,B
2013,264,Male,Johor,15,9,5,2,31,28,59,C
2018,265,Male,Sabah,18,4,10,4,36,22,58,C
2016,266,Male,Pahang,19,3,3,4,29,34,63,B
2012,267,Male,Selangor,17,5,9,1,32,40,72,B
2014,268,Male,Sarawak,17,10,4,1,32,34,66,B
2014,269,Male,Kelantan,21,10,4,3,38,26,64,B
2014,270,Female,Kelantan,21,7,5,1,34,36,70,B
2017,271,Male,Malacca,16,5,8,5,34,29,63,B
2019,272,Male,Sabah,16,3,10,2,31,40,71,B
2013,273,Male,Kedah,14,4,5,4,27,38,65,B
2018,274,Female,Johor,16,6,7,5,34,35,69,B
2014,275,Male,Sarawak,14,6,9,2,31,35,66,B
2017,276,Male,Malacca,15,9,9,5,38,39,77,B
2013,277,Male,Perlis,14,9,6,4,33,31,64,B
2013,278,Female,Malacca,20,5,8,3,36,23,59,C
2018,279,Male,Negeri Sembilan,17,6,7,4,34,22,56,C
2018,280,Male,Johor,13,3,6,3,25,29,54,C
2013,281,Female,Terengganu,16,6,6,3,31,32,63,B
2018,282,Male,Johor,20,9,4,2,35,37,72,B
2015,283,Male,Selangor,16,10,10,4,40,33,73,B
2019,284,Male,Pahang,21,9,4,5,39,30,69,B
2015,285,Female,Perak,16,9,7,4,36,40,76,B
2012,286,Male,Sarawak,21,10,7,2,40,31,71,B
2017,287,Female,Penang,20,9,5,5,39,33,72,B
2013,288,Male,Kelantan,15,9,5,5,34,40,74,B
2018,289,Male,Johor,20,10,4,4,38,31,69,B
2019,290,Female,Perlis,21,5,9,1,36,34,70,B
2017,291,Male,Sabah,20,9,6,4,39,28,67,B
2014,292,Male,Kedah,17,5,4,1,27,23,50,C
2014,293,Male,Sarawak,17,7,6,4,34,23,57,C
2012,294,Male,Perak,13,9,7,1,30,39,69,B
2012,295,Male,Perlis,17,8,7,5,37,26,63,B
2019,296,Male,Selangor,13,6,7,3,29,38,67,B
2018,297,Female,Kelantan,14,7,4,1,26,38,64,B
2016,298,Female,Perak,17,5,9,3,34,27,61,B
2019,299,Male,Malacca,13,10,4,2,29,30,59,C
2017,300,Male,Sabah,20,3,6,3,32,35,67,B
2018,301,Female,Pahang,17,4,6,5,32,36,68,B
2015,302,Female,Terengganu,16,10,4,5,35,39,74,B
2013,303,Female,Perak,19,8,7,1,35,22,57,C
2018,304,Female,Malacca,16,10,3,3,32,32,64,B
2017,305,Male,Sabah,20,7,5,2,34,22,56,C
2019,306,Male,Selangor,20,5,8,5,38,31,69,B
2018,307,Male,Negeri Sembilan,20,6,7,4,37,37,74,B
2019,308,Female,Sabah,15,6,10,4,35,33,68,B
2012,309,Male,Kedah,13,5,9,3,30,31,61,B
2013,310,Male,Johor,15,5,6,3,29,32,61,B
2014,311,Male,Sarawak,19,3,8,4,34,33,67,B
2018,312,Male,Perak,16,6,6,4,32,28,60,B
2012,313,Male,Perak,17,8,8,3,36,22,58,C
2016,314,Male,Selangor,16,6,3,2,27,35,62,B
2014,315,Male,Selangor,17,8,4,1,30,26,56,C
2019,316,Male,Perak,14,8,4,1,27,31,58,C
2017,317,Female,Penang,16,7,8,5,36,38,74,B
2015,318,Female,Perlis,16,9,5,4,34,36,70,B
2016,319,Female,Sabah,15,9,6,5,35,30,65,B
2012,320,Female,Kelantan,21,9,3,4,37,30,67,B
2013,321,Male,Johor,17,3,8,5,33,23,56,C
2019,322,Female,Pahang,16,8,9,1,34,24,58,C
2018,323,Male,Perak,14,8,4,1,27,29,56,C
2015,324,Male,Pahang,14,4,9,1,28,28,56,C
2019,325,Male,Penang,18,3,4,1,26,27,53,C
2018,326,Female,Negeri Sembilan,14,4,10,5,33,32,65,B
2016,327,Male,Malacca,14,4,6,5,29,37,66,B
2016,328,Male,Johor,21,6,5,4,36,25,61,B
2013,329,Male,Kelantan,14,8,3,1,26,30,56,C
2016,330,Female,Pahang,17,8,5,5,35,33,68,B
2012,331,Male,Kelantan,21,3,10,1,35,36,71,B
2013,332,Female,Negeri Sembilan,18,6,4,5,33,27,60,B
2015,333,Female,Terengganu,18,3,5,1,27,37,64,B
2017,334,Female,Selangor,13,5,9,2,29,26,55,C
2013,335,Female,Perlis,13,3,3,5,24,29,53,C
2017,336,Female,Penang,18,8,4,2,32,35,67,B
2013,337,Male,Pahang,20,8,5,4,37,32,69,B
2019,338,Male,Johor,20,7,3,2,32,37,69,B
2017,339,Male,Negeri Sembilan,21,6,10,2,39,27,66,B
2018,340,Female,Sabah,16,5,9,4,34,27,61,B
2014,341,Female,Kedah,14,9,5,4,32,34,66,B
2014,342,Male,Kedah,15,6,10,5,36,29,65,B
2014,343,Female,Selangor,19,8,10,4,41,24,65,B
2016,344,Female,Perak,15,3,4,4,26,35,61,B
2014,345,Male,Terengganu,20,7,8,3,38,29,67,B
2017,346,Male,Sarawak,14,7,7,2,30,39,69,B
2019,347,Male,Kedah,14,3,8,5,30,24,54,C
2019,348,Male,Malacca,13,6,4,4,27,25,52,C
2012,349,Male,Perak,17,4,9,1,31,22,53,C
2018,350,Female,Terengganu,14,3,9,4,30,25,55,C
2017,351,Female,Pahang,18,5,10,2,35,28,63,B
2014,352,Female,Malacca,20,9,4,3,36,30,66,B
2014,353,Male,Kedah,20,7,10,3,40,32,72,B
2012,354,Male,Sarawak,14,3,4,5,26,24,50,C
2013,355,Male,Malacca,16,6,7,3,32,32,64,B
2017,356,Female,Johor,21,8,5,4,38,36,74,B
2013,357,Female,Selangor,20,8,9,5,42,33,75,B
2013,358,Male,Sabah,14,8,7,4,33,24,57,C
2013,359,Male,Perak,21,3,6,2,32,34,66,B
2017,360,Female,Pahang,16,8,10,2,36,29,65,B
2017,361,Female,Malacca,19,7,3,3,32,36,68,B
2019,362,Female,Terengganu,13,4,6,3,26,40,66,B
2016,363,Male,Pahang,16,8,4,2,30,31,61,B
2016,364,Male,Malacca,21,5,6,1,33,31,64,B
2013,365,Female,Malacca,18,7,5,1,31,32,63,B
2013,366,Male,Negeri Sembilan,13,9,9,5,36,29,65,B
2019,367,Female,Selangor,19,4,4,3,30,31,61,B
2015,368,Male,Pahang,13,5,3,3,24,32,56,C
2012,369,Male,Kedah,17,5,4,1,27,27,54,C
2014,370,Male,Negeri Sembilan,20,3,3,2,28,37,65,B
2017,371,Male,Perlis,16,10,6,2,34,26,60,B
2019,372,Female,Perak,18,7,10,5,40,25,65,B
2018,373,Male,Johor,15,10,3,1,29,29,58,C
2017,374,Male,Malacca,17,4,3,2,26,28,54,C
2015,375,Male,Terengganu,17,5,5,3,30,39,69,B
2015,376,Male,Terengganu,16,3,6,3,28,39,67,B
2014,377,Male,Johor,21,9,8,4,42,39,81,A
2012,378,Female,Johor,21,8,4,2,35,28,63,B
2015,379,Male,Sarawak,19,7,3,3,32,23,55,C
2016,380,Male,Pahang,16,9,10,1,36,30,66,B
2019,381,Male,Johor,18,6,5,2,31,40,71,B
2014,382,Male,Perlis,18,10,8,2,38,24,62,B
2015,383,Female,Sarawak,14,3,3,2,22,25,47,F
2014,384,Female,Malacca,19,4,9,2,34,25,59,C
2017,385,Male,Sarawak,21,10,7,3,41,39,80,A
2013,386,Female,Sarawak,16,6,10,1,33,22,55,C
2019,387,Female,Negeri Sembilan,18,8,4,1,31,40,71,B
2018,388,Male,Sarawak,15,7,6,4,32,33,65,B
2014,389,Male,Pahang,21,8,10,3,42,31,73,B
2015,390,Male,Johor,13,6,3,4,26,27,53,C
2014,391,Male,Pahang,14,9,3,5,31,34,65,B
2013,392,Female,Kedah,16,10,9,5,40,40,80,A
2019,393,Male,Malacca,16,5,3,3,27,34,61,B
2016,394,Female,Negeri Sembilan,21,8,9,1,39,28,67,B
2013,395,Female,Selangor,20,9,6,3,38,33,71,B
2018,396,Female,Pahang,20,6,6,1,33,22,55,C
2018,397,Male,Sarawak,13,9,9,2,33,36,69,B
2019,398,Male,Perlis,20,4,10,4,38,31,69,B
2016,399,Male,Selangor,21,4,10,5,40,24,64,B
2016,400,Male,Terengganu,14,7,4,2,27,29,56,C
2014,401,Female,Selangor,21,8,8,3,40,35,75,B
2016,402,Male,Perlis,14,7,3,2,26,32,58,C
2017,403,Male,Sabah,18,8,5,1,32,22,54,C
2015,404,Female,Kedah,16,3,6,3,28,23,51,C
2015,405,Male,Johor,16,6,3,2,27,29,56,C
2015,406,Female,Perlis,21,8,3,1,33,38,71,B
2014,407,Male,Selangor,14,9,6,4,33,37,70,B
2012,408,Female,Malacca,17,9,5,3,34,30,64,B
2017,409,Male,Kelantan,17,8,3,4,32,32,64,B
2017,410,Female,Pahang,19,4,3,1,27,27,54,C
2014,411,Female,Perak,16,10,5,3,34,23,57,C
2012,412,Female,Penang,13,4,9,1,27,24,51,C
2012,413,Male,Sabah,17,5,5,1,28,39,67,B
2018,414,Male,Penang,16,7,9,5,37,23,60,B
2017,415,Male,Perak,18,9,9,5,41,40,81,A
2016,416,Male,Selangor,15,7,6,1,29,40,69,B
2015,417,Female,Perak,14,9,10,1,34,37,71,B
2015,418,Female,Sabah,15,6,7,5,33,24,57,C
2014,419,Female,Kelantan,15,3,5,3,26,28,54,C
2018,420,Male,Johor,19,5,3,2,29,35,64,B
2015,421,Female,Johor,17,10,3,1,31,37,68,B
2013,422,Female,Negeri Sembilan,20,3,9,3,35,37,72,B
2017,423,Male,Perak,21,6,9,5,41,40,81,A
2013,424,Female,Penang,19,8,7,5,39,23,62,B
2012,425,Male,Kelantan,15,10,7,2,34,34,68,B
2015,426,Female,Selangor,15,6,8,2,31,33,64,B
2018,427,Male,Pahang,18,10,3,3,34,27,61,B
2012,428,Male,Kelantan,17,7,6,5,35,38,73,B
2015,429,Male,Sabah,15,9,7,3,34,31,65,B
2014,430,Male,Perak,18,6,9,3,36,35,71,B
2019,431,Male,Negeri Sembilan,18,6,3,4,31,34,65,B
2018,432,Female,Malacca,13,8,3,5,29,32,61,B
2012,433,Female,Perlis,18,10,7,1,36,24,60,B
2014,434,Male,Perlis,19,4,10,4,37,30,67,B
2012,435,Female,Selangor,21,9,9,4,43,27,70,B
2013,436,Female,Kedah,21,9,6,4,40,37,77,B
2019,437,Female,Sabah,16,5,8,2,31,39,70,B
2018,438,Female,Kelantan,16,8,3,4,31,22,53,C
2017,439,Male,Selangor,16,9,10,3,38,22,60,B
2015,440,Female,Kedah,17,9,3,4,33,29,62,B
2015,441,Male,Penang,15,6,3,4,28,22,50,C
2018,442,Female,Perlis,17,6,5,3,31,32,63,B
2017,443,Male,Malacca,17,5,8,4,34,23,57,C
2012,444,Female,Selangor,13,10,5,3,31,23,54,C
2018,445,Male,Kelantan,19,5,6,1,31,27,58,C
2014,446,Male,Sarawak,20,3,6,1,30,36,66,B
2016,447,Male,Malacca,17,3,9,4,33,22,55,C
2019,448,Male,Penang,19,3,9,4,35,28,63,B
2015,449,Male,Kelantan,16,9,10,3,38,31,69,B
2017,450,Male,Penang,14,4,5,3,26,34,60,B
2013,451,Male,Terengganu,15,4,3,4,26,24,50,C
2016,452,Male,Johor,14,6,9,5,34,36,70,B
2017,453,Male,Selangor,17,7,10,4,38,25,63,B
2012,454,Male,Kedah,16,6,3,4,29,29,58,C
2014,455,Female,Terengganu,17,9,10,2,38,26,64,B
2018,456,Male,Malacca,21,6,7,2,36,39,75,B
2012,457,Female,Perak,13,3,5,4,25,39,64,B
2012,458,Female,Malacca,19,7,6,3,35,38,73,B
2013,459,Male,Johor,18,4,8,2,32,36,68,B
2015,460,Female,Johor,20,9,3,5,37,31,68,B
2018,461,Male,Johor,21,3,9,1,34,36,70,B
2014,462,Female,Kedah,21,8,6,4,39,34,73,B
2016,463,Male,Selangor,21,5,6,1,33,35,68,B
2019,464,Male,Johor,19,10,7,5,41,28,69,B
2016,465,Male,Malacca,18,9,7,1,35,30,65,B
2012,466,Male,Kedah,15,3,5,3,26,30,56,C
2016,467,Female,Pahang,14,9,4,2,29,31,60,B
2015,468,Male,Sabah,14,3,5,5,27,24,51,C
2017,469,Female,Kelantan,21,7,10,1,39,40,79,A
2015,470,Male,Kelantan,21,5,3,4,33,28,61,B
2014,471,Female,Perlis,13,8,7,5,33,31,64,B
2016,472,Female,Sarawak,13,7,9,5,34,28,62,B
2018,473,Female,Perlis,13,5,6,3,27,35,62,B
2013,474,Female,Terengganu,13,10,10,2,35,23,58,C
2018,475,Male,Sarawak,15,7,5,3,30,36,66,B
2017,476,Female,Kedah,19,9,6,2,36,22,58,C
2018,477,Female,Perak,16,9,10,3,38,26,64,B
2016,478,Male,Negeri Sembilan,15,6,5,2,28,26,54,C
2012,479,Female,Malacca,21,9,6,5,41,27,68,B
2013,480,Female,Perak,14,3,8,2,27,37,64,B
2013,481,Male,Kedah,16,5,6,5,32,38,70,B
2017,482,Male,Sabah,21,8,8,5,42,39,81,A
2019,483,Female,Perlis,20,5,9,1,35,27,62,B
2019,484,Male,Kedah,16,4,9,4,33,37,70,B
2014,485,Male,Penang,18,9,4,2,33,39,72,B
2013,486,Male,Terengganu,17,7,8,3,35,26,61,B
2019,487,Female,Negeri Sembilan,19,6,5,4,34,30,64,B
2015,488,Male,Kelantan,19,9,9,5,42,22,64,B
2014,489,Male,Johor,14,5,8,2,29,27,56,C
2018,490,Male,Malacca,15,7,3,2,27,40,67,B
2018,491,Male,Perlis,17,10,3,5,35,31,66,B
2017,492,Female,Sarawak,19,10,6,2,37,40,77,B
2015,493,Male,Sabah,19,4,6,2,31,29,60,B
2015,494,Female,Terengganu,20,5,4,5,34,31,65,B
2016,495,Female,Pahang,21,6,10,3,40,38,78,B
2013,496,Female,Perlis,19,9,4,1,33,33,66,B
2018,497,Female,Kedah,15,10,3,3,31,23,54,C
2019,498,Female,Kelantan,17,3,10,2,32,34,66,B
2012,499,Female,Sabah,13,9,4,2,28,39,67,B
2013,500,Female,Penang,21,9,6,5,41,36,77,B
2017,501,Male,Malacca,13,5,7,3,28,22,50,C
2019,502,Female,Malacca,13,4,4,4,25,27,52,C
2013,503,Male,Kedah,19,10,9,5,43,28,71,B
2014,504,Male,Pahang,21,5,6,2,34,23,57,C
2014,505,Female,Kelantan,19,7,7,4,37,39,76,B
2018,506,Female,Terengganu,15,4,4,2,25,22,47,F
2017,507,Male,Sabah,13,5,8,3,29,35,64,B
2013,508,Female,Terengganu,13,7,9,3,32,38,70,B
2013,509,Male,Malacca,19,10,6,3,38,35,73,B
2013,510,Male,Pahang,19,5,7,5,36,31,67,B
2012,511,Female,Penang,13,8,10,2,33,37,70,B
2018,512,Male,Perlis,17,9,7,3,36,32,68,B
2016,513,Male,Kedah,20,10,3,5,38,38,76,B
2018,514,Female,Selangor,17,5,4,3,29,26,55,C
2012,515,Female,Sabah,20,8,3,2,33,34,67,B
2016,516,Female,Malacca,18,5,6,4,33,37,70,B
2017,517,Female,Kedah,19,8,9,5,41,31,72,B
2017,518,Female,Perlis,14,10,3,5,32,27,59,C
2012,519,Male,Selangor,21,4,8,4,37,32,69,B
2017,520,Female,Kelantan,13,7,10,4,34,24,58,C
2016,521,Male,Penang,18,9,7,5,39,26,65,B
2018,522,Female,Negeri Sembilan,19,8,10,2,39,22,61,B
2017,523,Male,Penang,20,5,8,4,37,39,76,B
2018,524,Female,Perlis,14,8,10,1,33,34,67,B
2019,525,Female,Pahang,20,10,6,3,39,31,70,B
2017,526,Male,Kedah,16,5,7,3,31,25,56,C
2015,527,Female,Perlis,18,5,8,2,33,25,58,C
2012,528,Male,Sarawak,13,5,4,5,27,32,59,C
2017,529,Female,Terengganu,16,9,9,3,37,25,62,B
2015,530,Male,Terengganu,13,10,4,1,28,32,60,B
2012,531,Female,Perlis,19,8,6,4,37,30,67,B
2019,532,Male,Negeri Sembilan,20,6,9,4,39,31,70,B
2014,533,Female,Sabah,18,7,6,4,35,24,59,C
2019,534,Female,Negeri Sembilan,14,6,3,5,28,31,59,C
2015,535,Male,Kedah,20,10,3,1,34,31,65,B
2016,536,Female,Penang,20,4,3,5,32,36,68,B
2016,537,Male,Selangor,19,6,7,3,35,31,66,B
2015,538,Female,Penang,20,3,6,3,32,39,71,B
2019,539,Female,Pahang,14,3,7,3,27,31,58,C
2017,540,Female,Negeri Sembilan,19,4,5,1,29,31,60,B
2013,541,Female,Pahang,13,10,7,5,35,40,75,B
2017,542,Female,Johor,18,5,9,5,37,26,63,B
2016,543,Female,Malacca,21,5,6,3,35,33,68,B
2019,544,Male,Johor,14,5,3,1,23,35,58,C
2016,545,Male,Johor,20,5,4,2,31,27,58,C
2019,546,Male,Terengganu,14,5,7,4,30,27,57,C
2012,547,Male,Terengganu,15,4,5,4,28,39,67,B
2019,548,Male,Selangor,19,6,5,5,35,31,66,B
2013,549,Female,Kelantan,17,7,10,5,39,31,70,B
2016,550,Female,Perlis,14,7,3,4,28,34,62,B
2018,551,Female,Kedah,15,6,6,3,30,23,53,C
2015,552,Male,Sarawak,21,10,5,1,37,38,75,B
2018,553,Male,Perlis,15,3,7,1,26,26,52,C
2014,554,Female,Sarawak,13,3,10,4,30,30,60,B
2019,555,Female,Johor,16,5,6,2,29,34,63,B
2016,556,Female,Selangor,15,4,7,3,29,22,51,C
2015,557,Male,Selangor,17,4,9,3,33,30,63,B
2014,558,Female,Malacca,17,10,3,2,32,25,57,C
2018,559,Female,Negeri Sembilan,14,5,8,4,31,38,69,B
2015,560,Male,Terengganu,21,6,10,5,42,35,77,B
2016,561,Female,Perlis,14,5,5,1,25,34,59,C
2017,562,Male,Terengganu,15,7,7,5,34,29,63,B
2014,563,Female,Negeri Sembilan,19,4,5,5,33,25,58,C
2015,564,Male,Perlis,17,9,6,3,35,27,62,B
2015,565,Male,Terengganu,20,7,9,4,40,32,72,B
2015,566,Female,Perak,15,10,10,3,38,27,65,B
2016,567,Female,Sabah,19,3,10,3,35,22,57,C
2014,568,Female,Malacca,19,8,7,1,35,33,68,B
2012,569,Female,Pahang,13,10,9,5,37,26,63,B
2012,570,Male,Kelantan,17,10,8,5,40,35,75,B
2012,571,Female,Perlis,21,6,3,5,35,23,58,C
2013,572,Female,Penang,20,3,7,2,32,35,67,B
2016,573,Female,Penang,13,7,3,1,24,33,57,C
2016,574,Female,Johor,19,5,6,4,34,32,66,B
2015,575,Male,Sabah,13,9,10,4,36,25,61,B
2014,576,Female,Perlis,15,10,9,3,37,40,77,B
2012,577,Female,Perak,14,4,4,2,24,24,48,F
2015,578,Male,Perlis,19,6,9,1,35,28,63,B
2014,579,Male,Negeri Sembilan,16,7,8,5,36,27,63,B
2014,580,Female,Kelantan,21,3,10,2,36,25,61,B
2016,581,Female,Kedah,21,9,5,4,39,23,62,B
2014,582,Female,Sarawak,21,6,6,2,35,24,59,C
2013,583,Male,Sarawak,19,7,5,3,34,35,69,B
2013,584,Male,Sabah,21,4,3,4,32,31,63,B
2015,585,Male,Perak,21,6,10,1,38,36,74,B
2017,586,Female,Penang,19,8,5,5,37,24,61,B
2017,587,Female,Perlis,13,7,6,4,30,30,60,B
2012,588,Male,Negeri Sembilan,20,5,5,1,31,34,65,B
2013,589,Female,Terengganu,19,4,9,2,34,33,67,B
2015,590,Male,Sarawak,13,8,7,2,30,32,62,B
2018,591,Male,Perak,15,8,3,4,30,33,63,B
2012,592,Male,Malacca,18,9,3,5,35,24,59,C
2012,593,Male,Terengganu,20,9,10,4,43,32,75,B
2018,594,Male,Penang,13,6,9,5,33,24,57,C
2019,595,Male,Penang,21,6,3,1,31,37,68,B
2019,596,Male,Penang,20,4,8,4,36,36,72,B
2015,597,Female,Kelantan,21,3,9,1,34,26,60,B
2013,598,Female,Kelantan,14,6,7,2,29,32,61,B
2016,599,Female,Perak,19,10,5,5,39,31,70,B
2018,600,Male,Sarawak,13,3,6,3,25,32,57,C
2015,601,Male,Sabah,16,3,9,5,33,29,62,B
2012,602,Male,Perlis,18,8,3,2,31,25,56,C
2012,603,Female,Terengganu,13,4,7,2,26,34,60,B
2015,604,Male,Pahang,14,4,9,5,32,36,68,B
2015,605,Male,Perak,16,9,9,1,35,40,75,B
2014,606,Male,Kedah,21,9,7,2,39,32,71,B
2016,607,Male,Kelantan,14,8,4,3,29,29,58,C
2012,608,Male,Perlis,20,6,3,2,31,29,60,B
2018,609,Male,Pahang,18,5,5,4,32,24,56,C
2017,610,Female,Perak,19,4,6,5,34,34,68,B
2018,611,Female,Penang,16,6,10,2,34,35,69,B
2017,612,Male,Johor,16,7,5,3,31,39,70,B
2015,613,Female,Kelantan,18,6,3,3,30,37,67,B
2017,614,Male,Terengganu,21,5,8,4,38,40,78,B
2016,615,Male,Penang,17,6,6,5,34,33,67,B
2012,616,Male,Negeri Sembilan,17,10,5,1,33,39,72,B
2013,617,Female,Perlis,17,6,4,3,30,31,61,B
2018,618,Female,Sabah,14,4,5,4,27,24,51,C
2019,619,Female,Perak,18,9,8,4,39,24,63,B
2018,620,Male,Kelantan,14,3,4,4,25,31,56,C
2017,621,Male,Penang,13,5,9,3,30,35,65,B
2014,622,Male,Perak,19,9,3,3,34,28,62,B
2017,623,Male,Johor,16,5,4,3,28,38,66,B
2014,624,Male,Perak,16,8,10,5,39,36,75,B
2016,625,Male,Kelantan,19,4,10,2,35,25,60,B
2012,626,Male,Johor,18,8,8,1,35,25,60,B
2015,627,Male,Sabah,13,7,5,2,27,32,59,C
2013,628,Male,Negeri Sembilan,16,4,4,4,28,30,58,C
2017,629,Male,Perlis,15,3,7,4,29,29,58,C
2019,630,Male,Sarawak,15,3,10,4,32,36,68,B
2014,631,Male,Johor,21,7,5,1,34,27,61,B
2012,632,Female,Johor,14,4,8,5,31,24,55,C
2017,633,Female,Penang,20,7,6,2,35,32,67,B
2016,634,Male,Selangor,16,4,6,4,30,33,63,B
2012,635,Female,Kedah,14,9,4,1,28,26,54,C
2015,636,Male,Penang,17,10,10,1,38,38,76,B
2017,637,Male,Perak,14,5,3,2,24,35,59,C
2015,638,Male,Terengganu,15,9,6,3,33,34,67,B
2012,639,Female,Penang,21,10,4,2,37,38,75,B
2012,640,Female,Selangor,13,6,10,1,30,34,64,B
2014,641,Female,Sarawak,18,6,8,1,33,36,69,B
2018,642,Male,Sabah,18,8,7,5,38,29,67,B
2018,643,Female,Terengganu,18,3,9,2,32,37,69,B
2019,644,Male,Perak,20,7,6,4,37,38,75,B
2015,645,Female,Malacca,18,7,8,4,37,32,69,B
2013,646,Male,Sabah,15,8,8,3,34,27,61,B
2014,647,Female,Negeri Sembilan,15,9,7,2,33,31,64,B
2018,648,Female,Johor,21,3,6,5,35,38,73,B
2018,649,Male,Kelantan,17,9,9,5,40,30,70,B
2019,650,Male,Sarawak,18,10,5,3,36,31,67,B
2017,651,Male,Selangor,18,4,9,4,35,39,74,B
2017,652,Male,Perlis,16,8,10,3,37,38,75,B
2017,653,Male,Kedah,19,4,3,4,30,31,61,B
2016,654,Male,Kelantan,17,3,8,3,31,23,54,C
2012,655,Female,Malacca,20,6,7,1,34,25,59,C
2012,656,Female,Perlis,13,9,3,4,29,27,56,C
2018,657,Male,Perlis,15,4,7,1,27,27,54,C
2015,658,Male,Pahang,21,8,3,2,34,27,61,B
2017,659,Male,Kedah,13,4,7,2,26,35,61,B
2019,660,Female,Kelantan,16,5,9,3,33,29,62,B
2012,661,Female,Pahang,13,5,6,2,26,30,56,C
2016,662,Male,Kedah,16,8,3,1,28,36,64,B
2014,663,Female,Sarawak,19,6,10,4,39,23,62,B
2012,664,Female,Selangor,17,4,6,1,28,37,65,B
2012,665,Male,Pahang,20,7,10,3,40,37,77,B
2013,666,Female,Selangor,15,5,3,2,25,26,51,C
2014,667,Male,Negeri Sembilan,14,9,7,2,32,39,71,B
2014,668,Female,Sabah,18,5,7,3,33,36,69,B
2018,669,Male,Perlis,17,5,5,4,31,22,53,C
2016,670,Female,Sarawak,15,3,5,5,28,30,58,C
2015,671,Male,Sarawak,17,4,5,5,31,22,53,C
2019,672,Female,Perlis,21,7,10,1,39,37,76,B
2015,673,Female,Pahang,20,7,8,5,40,30,70,B
2015,674,Female,Negeri Sembilan,13,7,8,5,33,38,71,B
2013,675,Female,Selangor,21,5,8,5,39,26,65,B
2019,676,Female,Negeri Sembilan,16,5,5,5,31,28,59,C
2017,677,Male,Johor,16,10,4,4,34,33,67,B
2019,678,Female,Selangor,16,10,10,5,41,31,72,B
2012,679,Female,Perak,14,5,5,4,28,22,50,C
2013,680,Male,Kedah,18,4,3,3,28,40,68,B
2015,681,Female,Negeri Sembilan,21,8,3,3,35,30,65,B
2014,682,Male,Selangor,13,9,4,3,29,37,66,B
2016,683,Male,Kelantan,14,10,8,4,36,23,59,C
2017,684,Male,Kedah,17,9,9,2,37,25,62,B
2012,685,Male,Sarawak,20,7,8,4,39,29,68,B
2017,686,Male,Malacca,19,8,6,1,34,31,65,B
2018,687,Female,Sarawak,14,7,7,3,31,40,71,B
2013,688,Male,Perak,16,7,9,2,34,28,62,B
2012,689,Female,Kedah,18,5,5,2,30,37,67,B
2012,690,Male,Sabah,15,4,9,5,33,32,65,B
2012,691,Female,Perlis,17,5,4,5,31,30,61,B
2019,692,Female,Negeri Sembilan,19,10,4,1,34,40,74,B
2016,693,Female,Kedah,17,4,6,5,32,24,56,C
2019,694,Male,Selangor,21,4,8,5,38,24,62,B
2019,695,Male,Malacca,16,3,4,5,28,22,50,C
2015,696,Female,Terengganu,13,3,4,3,23,38,61,B
2015,697,Female,Selangor,17,8,5,1,31,39,70,B
2015,698,Female,Perlis,21,6,9,3,39,30,69,B
2018,699,Female,Kelantan,19,9,6,1,35,35,70,B
2014,700,Male,Selangor,14,10,4,5,33,31,64,B
2019,701,Female,Perlis,15,8,9,2,34,22,56,C
2017,702,Female,Kelantan,13,7,10,4,34,31,65,B
2019,703,Female,Johor,20,4,9,2,35,28,63,B
2012,704,Male,Sarawak,21,8,8,1,38,39,77,B
2017,705,Male,Perlis,20,3,6,2,31,23,54,C
2015,706,Male,Terengganu,20,10,4,2,36,26,62,B
2014,707,Male,Perak,18,8,3,2,31,38,69,B
2013,708,Female,Kedah,18,9,10,3,40,33,73,B
2018,709,Female,Selangor,15,8,8,3,34,29,63,B
2014,710,Female,Negeri Sembilan,14,5,10,2,31,24,55,C
2015,711,Male,Pahang,21,10,8,2,41,29,70,B
2015,712,Female,Perak,21,3,10,2,36,38,74,B
2013,713,Female,Johor,21,9,10,1,41,40,81,A
2012,714,Female,Perak,15,10,4,5,34,33,67,B
2014,715,Male,Terengganu,21,10,8,1,40,38,78,B
2015,716,Male,Perak,18,5,10,3,36,39,75,B
2017,717,Male,Johor,16,4,6,2,28,34,62,B
2016,718,Male,Kelantan,14,6,3,3,26,32,58,C
2016,719,Male,Perak,13,5,3,4,25,25,50,C
2018,720,Male,Kelantan,20,8,10,5,43,39,82,A
2013,721,Female,Sarawak,17,4,4,5,30,31,61,B
2019,722,Male,Terengganu,17,7,4,4,32,35,67,B
2014,723,Male,Perlis,15,3,3,1,22,40,62,B
2012,724,Female,Pahang,14,6,5,1,26,32,58,C
2019,725,Male,Penang,21,7,10,2,40,26,66,B
2019,726,Male,Negeri Sembilan,21,7,7,3,38,23,61,B
2014,727,Female,Penang,19,10,3,4,36,26,62,B
2018,728,Female,Sarawak,17,3,6,3,29,29,58,C
2015,729,Male,Perak,21,10,10,1,42,22,64,B
2013,730,Male,Pahang,18,5,6,4,33,29,62,B
2013,731,Male,Terengganu,15,5,8,4,32,27,59,C
2014,732,Male,Perlis,13,5,10,5,33,39,72,B
2016,733,Female,Malacca,21,6,10,2,39,27,66,B
2012,734,Male,Malacca,14,4,3,4,25,27,52,C
2015,735,Male,Penang,16,3,3,4,26,32,58,C
2014,736,Male,Perlis,20,9,8,1,38,32,70,B
2016,737,Male,Negeri Sembilan,18,7,7,5,37,34,71,B
2018,738,Male,Penang,21,7,5,2,35,37,72,B
2016,739,Female,Kelantan,14,10,3,5,32,30,62,B
2019,740,Male,Perlis,17,6,3,5,31,37,68,B
2018,741,Male,Selangor,19,4,3,3,29,33,62,B
2013,742,Female,Terengganu,14,7,8,3,32,27,59,C
2013,743,Male,Selangor,14,6,5,1,26,38,64,B
2013,744,Female,Kelantan,16,6,3,5,30,33,63,B
2017,745,Male,Sarawak,15,7,6,4,32,33,65,B
2014,746,Female,Perlis,18,10,4,5,37,25,62,B
2018,747,Female,Kedah,16,10,4,5,35,39,74,B
2015,748,Female,Perak,13,3,7,5,28,37,65,B
2013,749,Male,Perak,20,6,3,2,31,22,53,C
2013,750,Female,Sarawak,16,5,6,1,28,26,54,C
2018,751,Female,Kedah,17,7,6,4,34,38,72,B
2015,752,Male,Pahang,14,10,4,1,29,33,62,B
2017,753,Male,Malacca,18,3,10,2,33,29,62,B
2014,754,Male,Kelantan,13,5,7,3,28,35,63,B
2015,755,Female,Kelantan,17,8,5,2,32,31,63,B
2015,756,Male,Perlis,20,5,7,4,36,35,71,B
2018,757,Male,Perak,15,3,3,2,23,33,56,C
2018,758,Male,Selangor,18,9,5,2,34,27,61,B
2012,759,Female,Sabah,19,5,10,4,38,31,69,B
2013,760,Male,Perak,14,4,4,3,25,23,48,F
2013,761,Female,Pahang,13,7,10,3,33,29,62,B
2012,762,Female,Sarawak,20,3,6,4,33,35,68,B
2014,763,Male,Johor,13,6,3,1,23,29,52,C
2015,764,Male,Malacca,18,8,6,4,36,38,74,B
2015,765,Female,Sarawak,14,9,3,5,31,39,70,B
2015,766,Male,Perlis,20,6,9,1,36,40,76,B
2014,767,Female,Perlis,20,8,6,4,38,23,61,B
2014,768,Male,Johor,21,10,8,2,41,24,65,B
2019,769,Female,Johor,20,5,8,5,38,23,61,B
2018,770,Male,Johor,18,5,8,2,33,34,67,B
2014,771,Male,Sabah,13,3,9,3,28,25,53,C
2012,772,Male,Perlis,21,7,7,1,36,40,76,B
2015,773,Male,Perlis,13,3,3,1,20,40,60,B
2013,774,Male,Kelantan,21,10,8,1,40,31,71,B
2018,775,Female,Kedah,17,8,7,4,36,24,60,B
2019,776,Female,Negeri Sembilan,14,7,4,5,30,24,54,C
2016,777,Male,Selangor,14,8,10,2,34,30,64,B
2017,778,Female,Penang,15,4,5,2,26,24,50,C
2016,779,Female,Penang,13,7,7,2,29,34,63,B
2019,780,Female,Kelantan,21,4,4,3,32,23,55,C
2015,781,Female,Sarawak,21,5,10,4,40,33,73,B
2012,782,Female,Perlis,17,9,9,3,38,32,70,B
2016,783,Male,Selangor,14,3,9,5,31,34,65,B
2013,784,Male,Sabah,14,3,9,2,28,25,53,C
2019,785,Male,Selangor,13,10,3,2,28,31,59,C
2015,786,Male,Penang,17,3,10,2,32,28,60,B
2018,787,Female,Penang,14,4,8,5,31,34,65,B
2012,788,Male,Pahang,15,8,8,2,33,24,57,C
2019,789,Female,Sarawak,20,4,8,5,37,30,67,B
2012,790,Male,Kedah,13,5,8,1,27,31,58,C
2018,791,Female,Selangor,15,4,8,2,29,24,53,C
2013,792,Male,Sarawak,15,9,6,1,31,39,70,B
2014,793,Male,Sabah,18,3,3,2,26,32,58,C
2016,794,Male,Kelantan,15,4,4,2,25,26,51,C
2014,795,Male,Perlis,16,9,9,3,37,38,75,B
2017,796,Female,Terengganu,21,5,5,1,32,33,65,B
2012,797,Female,Pahang,16,10,5,4,35,28,63,B
2018,798,Female,Negeri Sembilan,19,3,8,2,32,30,62,B
2016,799,Female,Kelantan,13,9,9,3,34,32,66,B
2013,800,Female,Sarawak,17,6,6,4,33,35,68,B
2016,801,Female,Malacca,16,5,8,4,33,40,73,B
2012,802,Female,Sarawak,14,8,7,3,32,29,61,B
2012,803,Male,Sarawak,18,10,3,2,33,38,71,B
2018,804,Female,Johor,20,8,8,5,41,23,64,B
2015,805,Female,Terengganu,19,3,5,4,31,35,66,B
2019,806,Female,Terengganu,18,3,9,5,35,40,75,B
2017,807,Male,Sabah,17,8,4,1,30,37,67,B
2015,808,Male,Selangor,21,7,6,1,35,34,69,B
2014,809,Female,Penang,21,9,5,2,37,25,62,B
2018,810,Female,Negeri Sembilan,14,3,4,1,22,40,62,B
2012,811,Male,Terengganu,13,8,4,1,26,30,56,C
2013,812,Male,Kelantan,19,5,10,4,38,36,74,B
2015,813,Male,Pahang,20,6,7,3,36,34,70,B
2015,814,Male,Perlis,19,3,7,1,30,30,60,B
2016,815,Female,Kedah,17,5,7,5,34,26,60,B
2016,816,Female,Perak,17,9,8,1,35,28,63,B
2013,817,Male,Johor,17,9,10,1,37,34,71,B
2014,818,Male,Sarawak,17,7,4,2,30,37,67,B
2016,819,Female,Sarawak,21,7,8,5,41,28,69,B
2013,820,Female,Kelantan,19,10,6,5,40,38,78,B
2014,821,Female,Johor,21,6,8,4,39,37,76,B
2016,822,Female,Kedah,15,9,5,4,33,22,55,C
2018,823,Female,Sabah,20,4,4,4,32,27,59,C
2013,824,Male,Perak,13,3,6,1,23,38,61,B
2012,825,Male,Johor,13,5,8,1,27,40,67,B
2012,826,Male,Pahang,14,4,6,1,25,23,48,F
2015,827,Female,Negeri Sembilan,15,6,3,3,27,23,50,C
2013,828,Female,Terengganu,18,6,3,5,32,31,63,B
2015,829,Female,Perak,19,7,6,1,33,23,56,C
2014,830,Male,Terengganu,19,10,7,4,40,28,68,B
2014,831,Female,Sabah,13,6,10,4,33,34,67,B
2019,832,Female,Malacca,16,8,7,2,33,30,63,B
2018,833,Male,Perlis,18,3,7,1,29,40,69,B
2019,834,Male,Perlis,17,8,10,4,39,25,64,B
2015,835,Female,Pahang,17,5,3,2,27,35,62,B
2018,836,Female,Negeri Sembilan,20,5,3,5,33,36,69,B
2017,837,Male,Pahang,20,6,4,5,35,32,67,B
2016,838,Female,Perak,18,8,3,4,33,22,55,C
2018,839,Male,Pahang,21,9,5,4,39,29,68,B
2013,840,Female,Terengganu,18,8,6,3,35,34,69,B
2016,841,Male,Sarawak,21,7,8,4,40,30,70,B
2016,842,Male,Sarawak,21,10,6,3,40,35,75,B
2018,843,Male,Malacca,19,5,3,5,32,27,59,C
2013,844,Male,Pahang,14,4,3,4,25,35,60,B
2017,845,Male,Terengganu,15,8,10,1,34,36,70,B
2016,846,Female,Negeri Sembilan,21,7,6,2,36,33,69,B
2013,847,Male,Johor,14,5,6,5,30,39,69,B
2013,848,Male,Sabah,13,10,10,4,37,34,71,B
2017,849,Male,Johor,14,9,10,1,34,22,56,C
2018,850,Male,Penang,18,5,10,3,36,28,64,B
2016,851,Male,Terengganu,16,7,3,4,30,31,61,B
2014,852,Male,Johor,13,10,4,2,29,25,54,C
2019,853,Male,Sarawak,13,4,4,4,25,32,57,C
2019,854,Female,Sabah,14,5,3,5,27,22,49,F
2019,855,Female,Pahang,13,3,3,2,21,35,56,C
2018,856,Female,Malacca,16,7,5,1,29,31,60,B
2016,857,Female,Perlis,14,9,3,1,27,22,49,F
2012,858,Male,Sabah,15,3,8,5,31,28,59,C
2019,859,Female,Pahang,18,10,9,4,41,34,75,B
2016,860,Female,Sabah,21,7,9,1,38,28,66,B
2013,861,Female,Malacca,14,3,10,5,32,35,67,B
2015,862,Male,Pahang,21,5,3,3,32,33,65,B
2015,863,Female,Negeri Sembilan,21,6,4,5,36,36,72,B
2016,864,Female,Kelantan,14,5,4,4,27,29,56,C
2016,865,Male,Negeri Sembilan,21,4,4,1,30,25,55,C
2013,866,Male,Kelantan,13,10,5,4,32,39,71,B
2014,867,Female,Johor,16,4,6,1,27,25,52,C
2014,868,Female,Penang,15,7,3,1,26,24,50,C
2015,869,Female,Perak,16,5,10,2,33,40,73,B
2019,870,Female,Malacca,14,5,9,4,32,39,71,B
2018,871,Female,Johor,20,6,3,4,33,35,68,B
2019,872,Female,Johor,14,5,9,4,32,29,61,B
2016,873,Female,Pahang,21,4,3,3,31,38,69,B
2016,874,Male,Selangor,20,8,4,1,33,26,59,C
2016,875,Male,Sabah,14,9,5,5,33,25,58,C
2014,876,Male,Kelantan,15,9,8,3,35,38,73,B
2014,877,Female,Sarawak,14,9,5,4,32,33,65,B
2015,878,Male,Sabah,17,9,4,1,31,36,67,B
2019,879,Male,Selangor,15,3,9,2,29,26,55,C
2013,880,Female,Selangor,13,8,3,1,25,23,48,F
2015,881,Female,Kelantan,17,4,7,1,29,23,52,C
2013,882,Female,Penang,21,6,7,4,38,23,61,B
2015,883,Female,Kelantan,14,7,6,4,31,39,70,B
2019,884,Male,Terengganu,15,9,6,5,35,37,72,B
2012,885,Female,Perlis,19,6,4,5,34,23,57,C
2017,886,Female,Perlis,17,6,5,4,32,28,60,B
2019,887,Female,Johor,14,7,9,1,31,40,71,B
2013,888,Female,Sarawak,14,7,7,2,30,24,54,C
2015,889,Female,Malacca,19,6,3,5,33,32,65,B
2012,890,Male,Sarawak,17,10,3,4,34,22,56,C
2014,891,Female,Sabah,18,4,4,4,30,32,62,B
2012,892,Male,Terengganu,20,10,8,3,41,35,76,B
2012,893,Male,Perak,14,6,7,1,28,40,68,B
2019,894,Female,Negeri Sembilan,14,4,4,2,24,35,59,C
2012,895,Female,Malacca,14,9,8,4,35,40,75,B
2017,896,Female,Kelantan,14,6,4,2,26,33,59,C
2017,897,Female,Sarawak,20,4,3,1,28,31,59,C
2017,898,Male,Pahang,14,3,7,3,27,24,51,C
2018,899,Female,Johor,13,6,8,4,31,35,66,B
2016,900,Female,Malacca,19,5,7,5,36,24,60,B
2016,901,Male,Pahang,14,9,3,3,29,39,68,B
2017,902,Male,Selangor,18,9,10,3,40,34,74,B
2012,903,Female,Malacca,16,3,6,3,28,37,65,B
2015,904,Male,Johor,21,3,6,4,34,22,56,C
2016,905,Female,Malacca,18,9,10,4,41,29,70,B
2016,906,Female,Johor,20,8,7,5,40,25,65,B
2012,907,Female,Sarawak,19,3,3,2,27,38,65,B
2014,908,Male,Pahang,13,6,3,5,27,23,50,C
2012,909,Female,Sabah,21,3,9,5,38,37,75,B
2016,910,Male,Selangor,18,5,7,5,35,22,57,C
2013,911,Male,Selangor,21,5,10,5,41,29,70,B
2015,912,Female,Negeri Sembilan,14,10,8,1,33,40,73,B
2013,913,Female,Negeri Sembilan,14,4,6,2,26,33,59,C
2017,914,Male,Negeri Sembilan,14,10,3,1,28,33,61,B
2012,915,Male,Sarawak,18,6,7,4,35,26,61,B
2014,916,Male,Johor,18,5,6,3,32,37,69,B
2013,917,Female,Sabah,20,3,8,2,33,31,64,B
2018,918,Female,Kedah,20,3,3,3,29,39,68,B
2017,919,Male,Johor,17,5,9,2,33,24,57,C
2013,920,Female,Sarawak,15,5,4,2,26,32,58,C
2016,921,Female,Johor,19,6,5,1,31,31,62,B
2017,922,Male,Pahang,15,10,10,2,37,35,72,B
2019,923,Female,Selangor,16,7,7,1,31,33,64,B
2014,924,Male,Sabah,15,6,8,3,32,29,61,B
2019,925,Female,Penang,20,9,3,2,34,25,59,C
2014,926,Female,Negeri Sembilan,16,10,8,4,38,34,72,B
2012,927,Female,Malacca,15,6,10,2,33,33,66,B
2017,928,Female,Johor,14,6,7,2,29,39,68,B
2012,929,Male,Kelantan,16,8,7,5,36,35,71,B
2016,930,Male,Pahang,16,5,5,1,27,23,50,C
2017,931,Female,Penang,14,10,8,1,33,35,68,B
2013,932,Male,Sarawak,18,6,4,2,30,37,67,B
2017,933,Male,Terengganu,15,6,4,1,26,35,61,B
2015,934,Male,Negeri Sembilan,17,8,10,2,37,35,72,B
2019,935,Female,Kelantan,19,5,8,5,37,37,74,B
2016,936,Female,Johor,21,6,3,4,34,29,63,B
2018,937,Female,Penang,18,5,9,4,36,38,74,B
2017,938,Male,Terengganu,14,4,3,5,26,22,48,F
2018,939,Male,Perlis,19,8,5,3,35,39,74,B
2014,940,Male,Selangor,16,6,5,1,28,32,60,B
2013,941,Female,Sabah,20,7,8,2,37,28,65,B
2015,942,Female,Selangor,19,6,9,4,38,30,68,B
2016,943,Male,Sarawak,14,7,10,1,32,24,56,C
2012,944,Female,Pahang,17,7,3,5,32,26,58,C
2014,945,Female,Johor,15,3,10,4,32,24,56,C
2013,946,Female,Perlis,13,8,4,1,26,33,59,C
2012,947,Male,Perak,21,6,4,5,36,26,62,B
2017,948,Male,Negeri Sembilan,20,8,9,5,42,33,75,B
2012,949,Male,Kelantan,21,8,5,3,37,31,68,B
2019,950,Female,Pahang,19,10,8,1,38,30,68,B
2016,951,Male,Sarawak,21,5,10,1,37,31,68,B
2015,952,Male,Pahang,19,9,5,1,34,32,66,B
2014,953,Male,Pahang,16,10,9,1,36,38,74,B
2013,954,Female,Selangor,17,7,4,4,32,40,72,B
2012,955,Female,Malacca,13,6,7,4,30,24,54,C
2014,956,Female,Selangor,15,3,9,1,28,31,59,C
2014,957,Male,Kedah,19,4,9,5,37,26,63,B
2016,958,Female,Sabah,19,5,10,3,37,23,60,B
2019,959,Male,Perlis,20,7,3,4,34,39,73,B
2019,960,Male,Terengganu,20,10,10,1,41,38,79,A
2017,961,Female,Selangor,15,10,3,5,33,22,55,C
2013,962,Male,Perlis,13,7,6,2,28,29,57,C
2017,963,Female,Penang,19,3,10,2,34,28,62,B
2012,964,Female,Penang,15,10,3,1,29,33,62,B
2017,965,Male,Pahang,13,6,7,5,31,27,58,C
2016,966,Male,Penang,20,8,7,1,36,39,75,B
2016,967,Male,Terengganu,15,8,5,3,31,32,63,B
2016,968,Female,Sabah,17,6,5,2,30,35,65,B
2018,969,Female,Terengganu,16,4,7,1,28,35,63,B
2017,970,Male,Penang,14,8,4,3,29,32,61,B
2013,971,Female,Malacca,13,6,4,4,27,24,51,C
2018,972,Female,Sabah,18,5,8,4,35,35,70,B
2018,973,Female,Terengganu,20,4,3,1,28,40,68,B
2014,974,Female,Selangor,16,4,7,1,28,33,61,B
2019,975,Male,Kedah,16,4,6,4,30,34,64,B
2016,976,Male,Penang,19,5,4,1,29,29,58,C
2018,977,Female,Sarawak,18,3,9,1,31,25,56,C
2014,978,Female,Negeri Sembilan,19,6,6,5,36,27,63,B
2019,979,Male,Perak,19,7,4,5,35,37,72,B
2018,980,Male,Johor,16,3,4,2,25,29,54,C
2013,981,Female,Pahang,21,8,8,2,39,37,76,B
2013,982,Female,Negeri Sembilan,15,6,4,1,26,27,53,C
2017,983,Male,Malacca,19,3,4,2,28,33,61,B
2014,984,Male,Terengganu,19,5,10,5,39,24,63,B
2013,985,Male,Pahang,19,7,9,5,40,31,71,B
2012,986,Male,Negeri Sembilan,18,5,6,1,30,38,68,B
2013,987,Male,Perlis,21,6,7,5,39,30,69,B
2018,988,Female,Malacca,21,4,9,1,35,34,69,B
2012,989,Male,Terengganu,17,9,8,2,36,27,63,B
2015,990,Male,Selangor,16,5,9,1,31,23,54,C
2018,991,Female,Terengganu,13,7,3,5,28,37,65,B
2018,992,Female,Kelantan,19,8,4,2,33,29,62,B
2018,993,Female,Pahang,17,3,4,5,29,37,66,B
2016,994,Male,Selangor,16,8,7,1,32,26,58,C
2015,995,Female,Kedah,15,4,8,3,30,31,61,B
2012,996,Male,Malacca,19,7,7,3,36,39,75,B
2019,997,Male,Sabah,15,7,3,1,26,38,64,B
2019,998,Female,Penang,20,7,4,3,34,23,57,C
2012,999,Male,Sabah,20,9,8,1,38,27,65,B
2017,1000,Male,Kelantan,18,5,7,1,31,39,70,B
2017,1001,Male,Perlis,14,4,8,5,31,32,63,B
2019,1002,Female,Negeri Sembilan,20,9,6,4,39,35,74,B
2014,1003,Male,Selangor,18,3,4,4,29,27,56,C
2015,1004,Male,Pahang,13,10,8,4,35,29,64,B
2015,1005,Female,Negeri Sembilan,18,5,10,5,38,36,74,B
2015,1006,Female,Sarawak,19,6,7,1,33,36,69,B
2014,1007,Male,Johor,21,3,3,5,32,32,64,B
2016,1008,Female,Pahang,15,8,9,1,33,36,69,B
2019,1009,Female,Kedah,16,4,10,2,32,35,67,B
2017,1010,Female,Perlis,21,9,9,1,40,31,71,B
2019,1011,Female,Pahang,19,8,10,3,40,25,65,B
2012,1012,Female,Negeri Sembilan,20,4,5,5,34,32,66,B
2015,1013,Female,Terengganu,16,10,3,4,33,27,60,B
2018,1014,Female,Selangor,18,3,7,4,32,38,70,B
2017,1015,Female,Kelantan,18,6,10,3,37,30,67,B
2016,1016,Male,Perlis,18,7,10,3,38,22,60,B
2019,1017,Male,Selangor,14,4,10,3,31,34,65,B
2012,1018,Male,Kedah,19,6,9,1,35,26,61,B
2013,1019,Female,Terengganu,13,8,7,5,33,25,58,C
2013,1020,Female,Selangor,14,9,4,3,30,36,66,B
2014,1021,Female,Negeri Sembilan,13,5,10,5,33,23,56,C
2017,1022,Female,Sabah,15,4,9,3,31,34,65,B
2019,1023,Female,Perlis,19,4,7,3,33,37,70,B
2013,1024,Male,Malacca,13,10,5,4,32,40,72,B
2015,1025,Female,Selangor,17,3,4,1,25,29,54,C
2013,1026,Female,Negeri Sembilan,15,9,10,4,38,27,65,B
2013,1027,Male,Perlis,21,6,10,3,40,30,70,B
2014,1028,Male,Kelantan,19,3,5,5,32,38,70,B
2013,1029,Male,Penang,14,6,7,5,32,35,67,B
2014,1030,Female,Sarawak,19,9,10,1,39,29,68,B
2018,1031,Female,Kedah,15,8,5,4,32,39,71,B
2012,1032,Female,Sabah,19,9,9,5,42,38,80,A
2016,1033,Male,Johor,18,4,10,4,36,28,64,B
2012,1034,Female,Terengganu,18,3,8,4,33,22,55,C
2015,1035,Male,Malacca,18,7,9,4,38,38,76,B
2019,1036,Male,Perlis,19,6,3,2,30,36,66,B
2012,1037,Female,Johor,13,7,8,3,31,40,71,B
2018,1038,Male,Perlis,15,8,4,4,31,30,61,B
2018,1039,Female,Kedah,13,3,5,5,26,27,53,C
2013,1040,Male,Terengganu,17,9,5,5,36,26,62,B
2016,1041,Female,Sabah,15,9,8,3,35,36,71,B
2014,1042,Male,Pahang,21,7,10,1,39,35,74,B
2017,1043,Male,Negeri Sembilan,15,9,3,3,30,22,52,C
2016,1044,Male,Terengganu,20,4,7,5,36,31,67,B
2015,1045,Female,Johor,18,5,4,4,31,40,71,B
2012,1046,Female,Johor,20,4,9,3,36,30,66,B
2016,1047,Male,Penang,13,8,7,4,32,40,72,B
2017,1048,Male,Terengganu,17,8,3,5,33,25,58,C
2012,1049,Male,Negeri Sembilan,13,6,10,4,33,23,56,C
2016,1050,Female,Malacca,16,5,5,5,31,37,68,B
2014,1051,Male,Pahang,18,8,4,1,31,37,68,B
2012,1052,Male,Kelantan,19,4,6,1,30,28,58,C
2012,1053,Male,Penang,21,3,8,4,36,26,62,B
2016,1054,Male,Sabah,18,8,4,2,32,23,55,C
2019,1055,Male,Perak,17,4,9,5,35,38,73,B
2012,1056,Male,Negeri Sembilan,13,4,6,2,25,22,47,F
2015,1057,Female,Kelantan,13,9,5,4,31,35,66,B
2018,1058,Female,Penang,20,7,9,5,41,25,66,B
2013,1059,Female,Negeri Sembilan,21,5,5,2,33,35,68,B
2015,1060,Male,Malacca,19,7,4,5,35,32,67,B
2012,1061,Female,Perlis,21,5,5,4,35,29,64,B
2014,1062,Female,Johor,20,10,9,2,41,37,78,B
2014,1063,Female,Kelantan,17,6,4,1,28,32,60,B
2017,1064,Male,Kelantan,16,4,5,4,29,29,58,C
2017,1065,Male,Selangor,14,8,7,4,33,35,68,B
2013,1066,Female,Kedah,21,4,4,5,34,24,58,C
2012,1067,Male,Kedah,18,6,7,3,34,24,58,C
2015,1068,Female,Sarawak,15,5,9,4,33,31,64,B
2012,1069,Female,Terengganu,21,10,7,1,39,38,77,B
2019,1070,Female,Kedah,14,4,8,1,27,27,54,C
2019,1071,Female,Terengganu,15,3,7,5,30,38,68,B
2013,1072,Female,Sabah,15,4,6,3,28,32,60,B
2012,1073,Male,Kelantan,14,10,8,4,36,35,71,B
2017,1074,Male,Sarawak,16,10,9,5,40,23,63,B
2018,1075,Male,Terengganu,18,3,5,1,27,40,67,B
2015,1076,Male,Sabah,18,3,4,5,30,26,56,C
2012,1077,Male,Negeri Sembilan,20,4,3,3,30,40,70,B
2016,1078,Male,Kedah,21,7,4,1,33,35,68,B
2016,1079,Male,Sarawak,13,5,10,3,31,36,67,B
2016,1080,Male,Kelantan,18,3,5,3,29,24,53,C
2018,1081,Female,Negeri Sembilan,13,6,9,5,33,32,65,B
2018,1082,Male,Terengganu,20,4,5,3,32,40,72,B
2017,1083,Female,Terengganu,14,7,5,3,29,22,51,C
2019,1084,Female,Selangor,20,6,9,2,37,26,63,B
2012,1085,Male,Sabah,16,3,3,2,24,29,53,C
2019,1086,Female,Penang,17,8,6,4,35,38,73,B
2013,1087,Female,Sabah,16,4,4,1,25,40,65,B
2016,1088,Male,Selangor,17,5,10,1,33,37,70,B
2012,1089,Female,Sabah,14,6,7,4,31,38,69,B
2017,1090,Male,Selangor,18,10,5,2,35,32,67,B
2016,1091,Male,Sarawak,18,3,8,4,33,31,64,B
2018,1092,Male,Penang,17,7,5,4,33,31,64,B
2019,1093,Male,Sarawak,18,6,10,2,36,40,76,B
2013,1094,Male,Sarawak,18,3,4,3,28,37,65,B
2014,1095,Female,Negeri Sembilan,17,10,4,3,34,39,73,B
2015,1096,Male,Selangor,17,4,8,3,32,37,69,B
2017,1097,Male,Terengganu,13,5,3,5,26,32,58,C
2013,1098,Female,Sarawak,16,8,3,4,31,33,64,B
2013,1099,Male,Kedah,15,8,10,4,37,39,76,B
2012,1100,Female,Negeri Sembilan,14,5,9,2,30,24,54,C
2012,1101,Female,Johor,19,3,10,1,33,34,67,B
2017,1102,Male,Negeri Sembilan,15,10,9,2,36,31,67,B
2015,1103,Female,Negeri Sembilan,16,3,9,1,29,40,69,B
2015,1104,Male,Negeri Sembilan,20,4,4,1,29,35,64,B
2014,1105,Male,Negeri Sembilan,20,8,10,2,40,31,71,B
2016,1106,Male,Terengganu,16,3,7,5,31,25,56,C
2012,1107,Female,Sarawak,15,10,5,2,32,28,60,B
2015,1108,Male,Sabah,21,4,8,2,35,28,63,B
2014,1109,Female,Johor,20,7,9,4,40,36,76,B
2019,1110,Female,Kedah,18,6,7,4,35,30,65,B
2017,1111,Male,Malacca,15,5,8,4,32,32,64,B
2012,1112,Female,Kelantan,15,4,3,4,26,29,55,C
2016,1113,Male,Pahang,17,8,8,2,35,34,69,B
2018,1114,Female,Sabah,15,5,10,2,32,25,57,C
2016,1115,Female,Selangor,19,8,8,3,38,27,65,B
2015,1116,Male,Penang,16,6,7,1,30,35,65,B
2016,1117,Female,Kedah,19,10,7,5,41,33,74,B
2013,1118,Female,Perak,15,10,8,2,35,29,64,B
2015,1119,Male,Perlis,14,5,6,4,29,39,68,B
2019,1120,Female,Sarawak,14,10,6,1,31,25,56,C
2018,1121,Female,Kedah,16,8,10,5,39,38,77,B
2015,1122,Male,Pahang,21,9,5,2,37,33,70,B
2012,1123,Male,Sabah,17,6,3,1,27,30,57,C
2013,1124,Female,Kelantan,17,8,10,2,37,24,61,B
2015,1125,Male,Sabah,17,6,7,3,33,26,59,C
2016,1126,Male,Negeri Sembilan,17,3,4,2,26,24,50,C
2018,1127,Male,Perak,14,3,4,5,26,24,50,C
2013,1128,Female,Negeri Sembilan,18,4,9,4,35,37,72,B
2012,1129,Male,Perlis,14,5,8,1,28,40,68,B
2016,1130,Male,Sabah,19,8,8,2,37,28,65,B
2015,1131,Male,Pahang,14,10,8,4,36,27,63,B
2018,1132,Male,Selangor,18,6,7,1,32,33,65,B
2012,1133,Male,Kedah,14,7,4,2,27,38,65,B
2013,1134,Female,Kelantan,19,10,4,4,37,32,69,B
2012,1135,Male,Kelantan,16,10,9,3,38,40,78,B
2013,1136,Female,Pahang,19,5,6,1,31,34,65,B
2016,1137,Female,Perlis,21,6,6,1,34,28,62,B
2012,1138,Male,Negeri Sembilan,18,5,3,5,31,39,70,B
2013,1139,Female,Johor,14,7,4,5,30,26,56,C
2016,1140,Female,Johor,21,10,10,3,44,35,79,A
2012,1141,Male,Perak,20,8,5,1,34,40,74,B
2013,1142,Male,Johor,21,9,7,1,38,22,60,B
2014,1143,Female,Sabah,16,4,10,1,31,37,68,B
2017,1144,Male,Selangor,13,8,7,3,31,34,65,B
2016,1145,Male,Negeri Sembilan,13,3,10,3,29,28,57,C
2015,1146,Male,Penang,16,8,10,1,35,38,73,B
2018,1147,Male,Penang,18,7,10,5,40,27,67,B
2014,1148,Male,Sarawak,13,9,3,3,28,23,51,C
2018,1149,Male,Sarawak,15,7,9,2,33,33,66,B
2019,1150,Female,Sarawak,18,5,8,1,32,33,65,B
2015,1151,Male,Terengganu,20,6,7,5,38,36,74,B
2015,1152,Male,Sarawak,16,5,7,4,32,31,63,B
2019,1153,Male,Kedah,17,10,9,3,39,28,67,B
2013,1154,Female,Johor,17,9,9,2,37,40,77,B
2019,1155,Male,Negeri Sembilan,20,7,4,2,33,40,73,B
2012,1156,Female,Perlis,18,9,3,3,33,39,72,B
2018,1157,Female,Kedah,15,6,5,5,31,35,66,B
2012,1158,Female,Negeri Sembilan,18,9,4,4,35,40,75,B
2017,1159,Female,Malacca,19,9,8,2,38,29,67,B
2015,1160,Male,Kedah,14,7,6,4,31,33,64,B
2019,1161,Male,Negeri Sembilan,21,5,5,5,36,34,70,B
2012,1162,Female,Perak,17,6,5,1,29,29,58,C
2015,1163,Female,Selangor,15,4,4,5,28,39,67,B
2014,1164,Male,Terengganu,15,3,3,3,24,31,55,C
2016,1165,Female,Malacca,16,8,8,5,37,37,74,B
2014,1166,Female,Pahang,14,9,6,5,34,29,63,B
2015,1167,Male,Kelantan,19,4,8,1,32,22,54,C
2019,1168,Female,Johor,20,3,6,2,31,23,54,C
2016,1169,Male,Malacca,14,6,5,3,28,34,62,B
2013,1170,Male,Sarawak,14,8,8,4,34,22,56,C
2013,1171,Male,Perlis,20,3,3,5,31,37,68,B
2012,1172,Female,Selangor,17,5,10,1,33,33,66,B
2016,1173,Female,Selangor,18,6,4,3,31,26,57,C
2013,1174,Female,Sabah,21,10,5,3,39,32,71,B
2018,1175,Female,Terengganu,20,10,3,2,35,36,71,B
2016,1176,Male,Penang,15,7,10,1,33,31,64,B
2018,1177,Female,Kelantan,19,5,9,2,35,26,61,B
2014,1178,Female,Sabah,18,7,10,1,36,22,58,C
2015,1179,Female,Selangor,18,9,6,4,37,36,73,B
2017,1180,Female,Sabah,15,9,8,3,35,22,57,C
2018,1181,Male,Pahang,14,6,7,5,32,22,54,C
2012,1182,Male,Sabah,15,10,3,5,33,27,60,B
2016,1183,Male,Negeri Sembilan,15,4,9,3,31,32,63,B
2019,1184,Male,Terengganu,18,10,5,3,36,25,61,B
2012,1185,Male,Penang,13,7,10,5,35,37,72,B
2019,1186,Male,Penang,13,8,9,3,33,37,70,B
2013,1187,Female,Penang,15,7,4,2,28,34,62,B
2013,1188,Male,Johor,16,4,7,2,29,24,53,C
2018,1189,Female,Perlis,13,4,5,4,26,37,63,B
2017,1190,Male,Penang,19,9,9,1,38,36,74,B
2015,1191,Female,Pahang,15,9,4,1,29,23,52,C
2019,1192,Male,Perlis,19,4,4,3,30,34,64,B
2017,1193,Female,Malacca,13,5,3,5,26,29,55,C
2014,1194,Female,Kedah,16,5,3,4,28,37,65,B
2014,1195,Female,Malacca,16,6,5,2,29,28,57,C
2013,1196,Female,Terengganu,21,5,4,1,31,30,61,B
2017,1197,Male,Sarawak,16,4,6,1,27,35,62,B
2012,1198,Female,Johor,15,5,10,5,35,24,59,C
2016,1199,Female,Kelantan,18,3,9,5,35,36,71,B
2017,1200,Female,Pahang,19,8,8,3,38,27,65,B
2013,1201,Male,Penang,19,5,7,5,36,36,72,B
2013,1202,Male,Sarawak,17,9,5,5,36,31,67,B
2019,1203,Female,Sabah,16,6,4,2,28,34,62,B
2012,1204,Female,Kedah,14,6,8,1,29,22,51,C
2017,1205,Female,Selangor,21,7,4,3,35,40,75,B
2015,1206,Male,Negeri Sembilan,17,5,4,3,29,40,69,B
2012,1207,Male,Kelantan,15,3,10,4,32,28,60,B
2018,1208,Female,Penang,19,4,4,4,31,40,71,B
2013,1209,Male,Pahang,17,9,4,5,35,33,68,B
2018,1210,Male,Sabah,15,3,4,2,24,34,58,C
2015,1211,Male,Johor,16,9,6,2,33,40,73,B
2013,1212,Male,Perlis,19,8,9,3,39,38,77,B
2016,1213,Female,Sabah,15,7,4,2,28,31,59,C
2013,1214,Male,Perlis,21,6,6,3,36,37,73,B
2016,1215,Male,Terengganu,18,6,5,2,31,30,61,B
2018,1216,Female,Negeri Sembilan,19,9,8,2,38,34,72,B
2017,1217,Male,Sabah,18,7,5,3,33,38,71,B
2018,1218,Female,Johor,21,7,9,1,38,37,75,B
2013,1219,Female,Johor,14,5,6,2,27,27,54,C
2012,1220,Female,Selangor,15,4,7,5,31,40,71,B
2019,1221,Female,Selangor,14,10,6,2,32,40,72,B
2012,1222,Female,Terengganu,15,6,5,1,27,40,67,B
2014,1223,Female,Perak,21,5,5,4,35,23,58,C
2015,1224,Male,Kelantan,18,6,3,3,30,23,53,C
2017,1225,Female,Penang,21,10,9,3,43,39,82,A
2012,1226,Male,Penang,16,9,4,2,31,37,68,B
2014,1227,Female,Negeri Sembilan,21,7,8,4,40,40,80,A
2019,1228,Female,Kedah,17,9,5,5,36,40,76,B
2018,1229,Male,Malacca,21,10,5,3,39,34,73,B
2016,1230,Male,Negeri Sembilan,21,8,6,3,38,37,75,B
2016,1231,Female,Perlis,20,3,5,5,33,38,71,B
2012,1232,Male,Terengganu,21,8,7,3,39,26,65,B
2013,1233,Female,Sarawak,18,7,10,3,38,32,70,B
2018,1234,Male,Johor,17,5,6,5,33,23,56,C
2019,1235,Male,Kelantan,17,9,9,4,39,38,77,B
2014,1236,Male,Pahang,20,10,10,4,44,32,76,B
2018,1237,Male,Sabah,15,6,9,2,32,35,67,B
2018,1238,Female,Selangor,18,3,9,1,31,40,71,B
2017,1239,Female,Selangor,19,3,9,3,34,28,62,B
2018,1240,Male,Negeri Sembilan,15,3,9,3,30,22,52,C
2019,1241,Male,Malacca,19,3,10,2,34,33,67,B
2012,1242,Male,Kedah,14,4,10,5,33,22,55,C
2018,1243,Female,Penang,13,10,4,4,31,39,70,B
2013,1244,Female,Pahang,13,6,10,5,34,26,60,B
2012,1245,Female,Sabah,20,8,4,4,36,28,64,B
2019,1246,Male,Sarawak,21,7,9,5,42,25,67,B
2016,1247,Female,Penang,16,4,4,4,28,22,50,C
2019,1248,Male,Malacca,21,3,3,5,32,35,67,B
2016,1249,Female,Perak,19,5,5,3,32,37,69,B
2013,1250,Male,Johor,19,7,3,3,32,28,60,B
2013,1251,Male,Sabah,18,7,7,2,34,38,72,B
2018,1252,Female,Sabah,17,4,6,5,32,25,57,C
2015,1253,Female,Terengganu,14,7,4,3,28,34,62,B
2017,1254,Female,Penang,17,4,3,4,28,38,66,B
2018,1255,Male,Pahang,20,9,3,5,37,33,70,B
2013,1256,Male,Perak,15,5,3,1,24,39,63,B
2018,1257,Male,Terengganu,20,3,4,4,31,23,54,C
2016,1258,Male,Johor,19,6,5,5,35,37,72,B
2016,1259,Male,Perak,15,7,4,1,27,31,58,C
2014,1260,Female,Terengganu,13,7,8,5,33,33,66,B
2015,1261,Female,Negeri Sembilan,19,4,5,3,31,31,62,B
2013,1262,Female,Sarawak,17,9,9,5,40,34,74,B
2014,1263,Male,Kelantan,15,10,3,5,33,34,67,B
2016,1264,Female,Sarawak,19,3,7,3,32,31,63,B
2013,1265,Female,Sarawak,18,7,7,2,34,24,58,C
2017,1266,Male,Perlis,17,10,3,3,33,27,60,B
2017,1267,Female,Sarawak,17,5,7,5,34,29,63,B
2013,1268,Female,Perlis,19,7,3,3,32,34,66,B
2014,1269,Female,Kelantan,16,4,7,2,29,36,65,B
2012,1270,Male,Sarawak,16,10,7,5,38,29,67,B
2019,1271,Male,Terengganu,19,9,6,3,37,37,74,B
2019,1272,Female,Sarawak,20,7,3,4,34,37,71,B
2019,1273,Female,Perlis,16,4,4,2,26,25,51,C
2016,1274,Male,Johor,14,6,10,1,31,38,69,B
2019,1275,Male,Pahang,20,10,8,2,40,31,71,B
2014,1276,Female,Pahang,19,8,4,1,32,33,65,B
2017,1277,Male,Malacca,20,3,3,3,29,32,61,B
2017,1278,Male,Selangor,13,5,10,5,33,33,66,B
2014,1279,Female,Johor,18,10,5,3,36,29,65,B
2019,1280,Male,Johor,19,4,8,2,33,40,73,B
2017,1281,Female,Kelantan,16,6,4,4,30,40,70,B
2014,1282,Female,Perlis,14,5,7,1,27,33,60,B
2017,1283,Female,Negeri Sembilan,14,8,3,2,27,37,64,B
2017,1284,Male,Penang,21,5,7,5,38,32,70,B
2012,1285,Female,Sabah,20,10,8,4,42,27,69,B
2018,1286,Male,Kelantan,19,7,7,4,37,28,65,B
2016,1287,Female,Malacca,13,7,4,2,26,34,60,B
2015,1288,Female,Selangor,20,5,4,2,31,29,60,B
2015,1289,Female,Negeri Sembilan,16,7,4,5,32,40,72,B
2014,1290,Female,Perlis,20,3,7,1,31,33,64,B
2018,1291,Male,Malacca,18,10,10,3,41,35,76,B
2019,1292,Female,Perak,20,4,7,4,35,22,57,C
2014,1293,Male,Kedah,15,3,5,3,26,34,60,B
2015,1294,Female,Negeri Sembilan,16,6,3,1,26,34,60,B
2019,1295,Female,Malacca,21,9,9,4,43,35,78,B
2017,1296,Male,Perlis,21,8,10,2,41,24,65,B
2017,1297,Female,Negeri Sembilan,19,4,9,4,36,34,70,B
2017,1298,Male,Selangor,20,4,7,2,33,26,59,C
2014,1299,Female,Selangor,20,5,10,4,39,27,66,B
2013,1300,Male,Johor,14,9,8,5,36,34,70,B
2017,1301,Female,Pahang,13,9,5,4,31,24,55,C
2014,1302,Female,Penang,21,5,3,1,30,30,60,B
2015,1303,Male,Kelantan,16,8,4,5,33,26,59,C
2014,1304,Male,Kedah,17,7,10,3,37,35,72,B
2016,1305,Female,Sabah,21,3,6,5,35,23,58,C
2014,1306,Male,Perlis,18,5,3,5,31,25,56,C
2015,1307,Male,Sabah,18,4,8,1,31,32,63,B
2014,1308,Male,Sarawak,13,3,9,3,28,35,63,B
2019,1309,Female,Selangor,20,6,9,5,40,35,75,B
2012,1310,Male,Sarawak,17,6,8,2,33,39,72,B
2013,1311,Male,Kedah,14,9,7,5,35,24,59,C
2013,1312,Female,Johor,17,3,7,2,29,40,69,B
2015,1313,Female,Selangor,19,7,3,4,33,31,64,B
2014,1314,Male,Kelantan,16,3,4,3,26,28,54,C
2019,1315,Female,Negeri Sembilan,16,7,9,1,33,38,71,B
2015,1316,Male,Pahang,18,3,5,5,31,30,61,B
2019,1317,Male,Kedah,15,5,8,5,33,26,59,C
2016,1318,Female,Kedah,20,3,8,1,32,32,64,B
2015,1319,Male,Penang,20,6,3,1,30,28,58,C
2014,1320,Female,Malacca,13,4,7,2,26,32,58,C
2015,1321,Male,Sarawak,18,6,8,3,35,40,75,B
2017,1322,Male,Sarawak,19,7,6,1,33,37,70,B
2012,1323,Female,Kedah,20,8,4,1,33,28,61,B
2017,1324,Male,Johor,16,8,9,1,34,35,69,B
2014,1325,Male,Selangor,20,8,4,5,37,29,66,B
2016,1326,Male,Kelantan,19,3,7,5,34,40,74,B
2014,1327,Female,Malacca,19,5,8,3,35,22,57,C
2014,1328,Male,Selangor,14,7,4,1,26,40,66,B
2015,1329,Male,Malacca,15,6,10,4,35,29,64,B
2012,1330,Female,Pahang,14,3,8,5,30,36,66,B
2019,1331,Male,Perak,16,10,8,5,39,34,73,B
2017,1332,Male,Malacca,20,8,3,2,33,26,59,C
2012,1333,Male,Perak,18,7,7,2,34,32,66,B
2015,1334,Male,Selangor,20,8,3,5,36,34,70,B
2019,1335,Male,Kelantan,20,4,6,3,33,23,56,C
2012,1336,Male,Sabah,19,10,3,1,33,23,56,C
2018,1337,Female,Selangor,13,9,9,3,34,25,59,C
2018,1338,Female,Kelantan,18,5,10,3,36,25,61,B
2013,1339,Female,Terengganu,19,5,3,4,31,40,71,B
2016,1340,Male,Pahang,19,6,10,3,38,38,76,B
2019,1341,Male,Sabah,18,4,9,3,34,26,60,B
2013,1342,Female,Terengganu,13,5,9,2,29,29,58,C
2018,1343,Male,Penang,18,3,6,1,28,24,52,C
2016,1344,Female,Johor,16,7,5,4,32,30,62,B
2015,1345,Male,Perak,18,8,6,5,37,23,60,B
2016,1346,Female,Pahang,20,5,8,2,35,28,63,B
2019,1347,Male,Perlis,18,4,7,5,34,37,71,B
2012,1348,Male,Pahang,17,6,5,4,32,25,57,C
2014,1349,Male,Kelantan,21,8,3,4,36,28,64,B
2019,1350,Male,Kedah,21,7,8,3,39,40,79,A
2019,1351,Female,Sabah,14,9,4,3,30,36,66,B
2015,1352,Male,Perlis,19,10,4,1,34,29,63,B
2016,1353,Male,Penang,20,6,10,2,38,37,75,B
2013,1354,Female,Kedah,14,10,6,1,31,28,59,C
2019,1355,Female,Perlis,14,10,5,2,31,22,53,C
2012,1356,Female,Perlis,18,10,3,4,35,33,68,B
2019,1357,Female,Selangor,15,7,9,1,32,39,71,B
2013,1358,Male,Perlis,15,4,4,4,27,32,59,C
2016,1359,Male,Kedah,21,4,6,2,33,37,70,B
2015,1360,Male,Kedah,21,3,9,3,36,27,63,B
2019,1361,Female,Terengganu,21,4,8,3,36,27,63,B
2014,1362,Male,Perlis,17,8,3,3,31,38,69,B
2012,1363,Male,Sabah,13,9,3,1,26,24,50,C
2017,1364,Male,Penang,21,6,8,3,38,23,61,B
2012,1365,Male,Kedah,13,10,4,4,31,25,56,C
2016,1366,Male,Perlis,14,6,4,5,29,28,57,C
2016,1367,Female,Pahang,20,10,6,2,38,35,73,B
2018,1368,Male,Selangor,20,7,7,4,38,27,65,B
2017,1369,Female,Kedah,20,6,5,4,35,25,60,B
2017,1370,Female,Johor,20,6,8,4,38,30,68,B
2017,1371,Female,Perlis,15,5,10,3,33,30,63,B
2016,1372,Female,Terengganu,20,4,4,2,30,28,58,C
2013,1373,Female,Selangor,18,9,3,4,34,39,73,B
2016,1374,Male,Terengganu,18,8,5,5,36,40,76,B
2014,1375,Male,Kedah,13,9,6,5,33,29,62,B
2014,1376,Female,Perak,13,6,5,3,27,38,65,B
2015,1377,Male,Malacca,16,3,5,3,27,29,56,C
2016,1378,Female,Sabah,16,7,8,4,35,36,71,B
2017,1379,Male,Negeri Sembilan,18,9,5,5,37,39,76,B
2018,1380,Female,Terengganu,18,5,10,1,34,26,60,B
2012,1381,Male,Johor,13,3,9,3,28,23,51,C
2018,1382,Female,Kedah,13,3,7,1,24,23,47,F
2016,1383,Male,Sabah,18,9,8,1,36,37,73,B
2018,1384,Female,Sarawak,19,9,3,2,33,26,59,C
2013,1385,Female,Sabah,18,7,4,3,32,28,60,B
2018,1386,Female,Malacca,20,3,3,2,28,28,56,C
2014,1387,Male,Perlis,18,9,3,5,35,40,75,B
2018,1388,Female,Penang,19,6,7,2,34,32,66,B
2014,1389,Female,Kelantan,15,8,8,4,35,35,70,B
2015,1390,Male,Johor,13,6,9,2,30,29,59,C
2012,1391,Female,Perak,13,4,4,5,26,40,66,B
2014,1392,Male,Selangor,21,9,7,4,41,35,76,B
2017,1393,Female,Perlis,19,8,7,2,36,32,68,B
2017,1394,Male,Perlis,16,6,6,5,33,37,70,B
2016,1395,Female,Penang,17,10,4,4,35,26,61,B
2013,1396,Female,Perlis,20,5,4,5,34,26,60,B
2012,1397,Male,Penang,14,5,7,3,29,38,67,B
2017,1398,Female,Negeri Sembilan,20,10,4,1,35,36,71,B
2012,1399,Female,Johor,14,9,9,4,36,34,70,B
2015,1400,Female,Kedah,15,6,4,5,30,24,54,C
2018,1401,Female,Kedah,16,4,9,5,34,29,63,B
2014,1402,Male,Malacca,16,7,6,4,33,35,68,B
2013,1403,Male,Terengganu,14,9,6,1,30,32,62,B
2016,1404,Female,Terengganu,19,7,8,1,35,23,58,C
2019,1405,Female,Negeri Sembilan,21,8,6,2,37,38,75,B
2017,1406,Female,Terengganu,20,5,8,1,34,29,63,B
2012,1407,Female,Kedah,17,9,5,1,32,30,62,B
2012,1408,Male,Malacca,21,7,7,5,40,29,69,B
2015,1409,Male,Kedah,17,10,10,2,39,36,75,B
2012,1410,Male,Kelantan,20,5,5,3,33,23,56,C
2017,1411,Male,Terengganu,15,3,3,4,25,32,57,C
2012,1412,Female,Perak,18,10,8,5,41,24,65,B
2015,1413,Male,Johor,17,3,9,3,32,28,60,B
2016,1414,Male,Perak,20,7,5,2,34,33,67,B
2018,1415,Female,Perlis,16,6,6,2,30,39,69,B
2017,1416,Male,Perak,19,6,5,3,33,26,59,C
2013,1417,Male,Sarawak,14,5,5,1,25,34,59,C
2014,1418,Female,Sarawak,15,4,10,2,31,28,59,C
2014,1419,Male,Kedah,21,4,8,2,35,35,70,B
2012,1420,Male,Terengganu,13,7,5,4,29,33,62,B
2019,1421,Male,Kedah,17,3,8,5,33,38,71,B
2019,1422,Female,Negeri Sembilan,17,3,7,3,30,34,64,B
2013,1423,Male,Sabah,21,5,5,5,36,34,70,B
2017,1424,Male,Sabah,18,3,6,3,30,24,54,C
2014,1425,Male,Negeri Sembilan,13,6,9,1,29,22,51,C
2015,1426,Male,Kelantan,14,3,7,4,28,31,59,C
2014,1427,Male,Malacca,18,8,9,4,39,30,69,B
2015,1428,Male,Terengganu,13,9,3,4,29,30,59,C
2019,1429,Female,Negeri Sembilan,14,4,4,5,27,40,67,B
2012,1430,Female,Selangor,16,5,3,3,27,36,63,B
2015,1431,Female,Sabah,18,5,6,4,33,24,57,C
2019,1432,Female,Sabah,17,7,4,4,32,25,57,C
2016,1433,Female,Terengganu,15,7,3,3,28,25,53,C
2019,1434,Female,Sabah,17,3,10,2,32,30,62,B
2012,1435,Female,Malacca,13,8,5,1,27,33,60,B
2019,1436,Female,Malacca,17,7,4,4,32,39,71,B
2016,1437,Male,Terengganu,18,4,7,5,34,34,68,B
2017,1438,Female,Perak,18,4,9,3,34,37,71,B
2016,1439,Female,Malacca,16,7,5,3,31,30,61,B
2012,1440,Female,Terengganu,21,10,8,4,43,29,72,B
2018,1441,Female,Penang,21,5,5,5,36,26,62,B
2012,1442,Male,Selangor,16,3,7,1,27,36,63,B
2015,1443,Male,Terengganu,19,6,10,5,40,35,75,B
2018,1444,Female,Perak,20,7,5,2,34,37,71,B
2015,1445,Female,Perlis,21,4,6,1,32,24,56,C
2015,1446,Male,Pahang,16,5,4,4,29,37,66,B
2013,1447,Male,Negeri Sembilan,13,6,9,5,33,26,59,C
2016,1448,Male,Terengganu,16,3,3,1,23,36,59,C
2018,1449,Male,Johor,21,10,9,2,42,27,69,B
2014,1450,Male,Malacca,18,5,5,2,30,26,56,C
2016,1451,Female,Selangor,19,8,6,3,36,25,61,B
2016,1452,Female,Terengganu,15,8,3,2,28,36,64,B
2015,1453,Female,Penang,15,10,4,2,31,33,64,B
2019,1454,Male,Sarawak,17,7,3,5,32,22,54,C
2018,1455,Male,Perak,15,4,6,1,26,26,52,C
2016,1456,Male,Selangor,19,4,8,2,33,28,61,B
2016,1457,Male,Sabah,15,7,10,4,36,32,68,B
2012,1458,Female,Terengganu,13,7,5,4,29,40,69,B
2018,1459,Male,Sabah,20,4,6,4,34,22,56,C
2017,1460,Female,Perlis,16,5,8,1,30,30,60,B
2013,1461,Female,Selangor,15,7,10,1,33,37,70,B
2012,1462,Female,Selangor,20,3,6,1,30,24,54,C
2017,1463,Female,Sarawak,18,5,3,5,31,27,58,C
2018,1464,Female,Sarawak,15,6,10,4,35,37,72,B
2015,1465,Male,Penang,20,7,4,5,36,40,76,B
2012,1466,Female,Perlis,14,3,7,2,26,33,59,C
2013,1467,Female,Penang,21,10,7,3,41,22,63,B
2019,1468,Male,Kedah,16,9,9,4,38,25,63,B
2016,1469,Female,Pahang,17,4,7,2,30,38,68,B
2018,1470,Male,Perak,16,7,9,4,36,29,65,B
2012,1471,Female,Malacca,16,4,4,4,28,26,54,C
2018,1472,Male,Selangor,17,9,10,1,37,39,76,B
2015,1473,Male,Perak,19,9,7,3,38,32,70,B
2016,1474,Male,Terengganu,14,5,4,3,26,28,54,C
2016,1475,Female,Sarawak,16,3,3,2,24,22,46,F
2015,1476,Male,Negeri Sembilan,18,7,6,5,36,25,61,B
2017,1477,Female,Johor,15,6,6,4,31,22,53,C
2015,1478,Female,Perak,21,8,9,2,40,40,80,A
2018,1479,Female,Penang,16,4,3,5,28,23,51,C
2013,1480,Male,Terengganu,21,9,9,3,42,37,79,A
2018,1481,Female,Malacca,20,7,3,4,34,26,60,B
2018,1482,Male,Perlis,17,6,3,2,28,37,65,B
2015,1483,Female,Terengganu,19,3,3,2,27,22,49,F
2013,1484,Male,Penang,18,10,8,5,41,27,68,B
2012,1485,Female,Perak,19,6,9,5,39,34,73,B
2017,1486,Male,Perlis,19,10,7,5,41,34,75,B
2012,1487,Female,Terengganu,20,5,8,3,36,36,72,B
2013,1488,Female,Perlis,13,9,5,5,32,35,67,B
2012,1489,Female,Selangor,20,6,6,2,34,35,69,B
2013,1490,Male,Penang,17,3,5,5,30,26,56,C
2015,1491,Male,Terengganu,16,8,8,3,35,35,70,B
2018,1492,Female,Negeri Sembilan,18,9,10,3,40,30,70,B
2012,1493,Female,Perlis,20,10,8,5,43,25,68,B
2014,1494,Male,Perak,20,7,9,2,38,40,78,B
2017,1495,Female,Perak,21,9,9,1,40,33,73,B
2015,1496,Male,Kedah,18,4,3,4,29,27,56,C
2018,1497,Male,Sabah,20,3,3,5,31,25,56,C
2018,1498,Female,Selangor,21,9,5,2,37,35,72,B
2013,1499,Male,Terengganu,14,4,3,3,24,27,51,C
2019,1500,Female,Malacca,18,6,10,5,39,32,71,B
2013,1501,Male,Kelantan,21,7,8,1,37,30,67,B
2018,1502,Male,Perak,18,6,6,2,32,31,63,B
2017,1503,Female,Terengganu,13,4,8,1,26,40,66,B
2017,1504,Female,Sabah,14,4,4,3,25,38,63,B
2017,1505,Male,Negeri Sembilan,15,8,7,4,34,36,70,B
2016,1506,Male,Selangor,14,7,7,2,30,38,68,B
2019,1507,Female,Selangor,14,7,8,5,34,39,73,B
2016,1508,Female,Selangor,21,3,3,3,30,24,54,C
2014,1509,Male,Perak,18,10,8,4,40,35,75,B
2019,1510,Female,Negeri Sembilan,20,8,7,2,37,22,59,C
2018,1511,Male,Malacca,18,4,4,1,27,31,58,C
2014,1512,Male,Johor,13,9,6,3,31,38,69,B
2016,1513,Female,Malacca,17,3,10,1,31,36,67,B
2012,1514,Male,Terengganu,20,4,3,4,31,26,57,C
2017,1515,Female,Perlis,20,7,9,3,39,37,76,B
2017,1516,Female,Perlis,18,10,3,2,33,25,58,C
2018,1517,Male,Penang,17,7,4,1,29,34,63,B
2015,1518,Male,Perak,19,8,6,4,37,40,77,B
2016,1519,Male,Negeri Sembilan,15,6,6,3,30,30,60,B
2018,1520,Female,Johor,21,5,10,3,39,39,78,B
2018,1521,Male,Penang,13,4,8,5,30,27,57,C
2014,1522,Female,Terengganu,20,7,5,5,37,28,65,B
2013,1523,Male,Negeri Sembilan,14,7,10,1,32,31,63,B
2019,1524,Male,Kedah,20,9,9,3,41,36,77,B
2014,1525,Female,Kedah,17,3,10,4,34,40,74,B
2012,1526,Female,Sabah,17,3,3,5,28,27,55,C
2018,1527,Female,Johor,13,9,10,3,35,32,67,B
2012,1528,Female,Sabah,21,3,10,1,35,40,75,B
2012,1529,Female,Johor,13,9,10,1,33,29,62,B
2019,1530,Female,Perlis,16,9,6,1,32,39,71,B
2019,1531,Female,Pahang,19,4,3,5,31,40,71,B
2017,1532,Female,Sabah,20,3,3,1,27,29,56,C
2018,1533,Male,Pahang,21,5,4,4,34,27,61,B
2014,1534,Male,Johor,13,5,8,3,29,25,54,C
2013,1535,Female,Negeri Sembilan,18,5,6,4,33,35,68,B
2019,1536,Female,Terengganu,20,5,9,4,38,30,68,B
2015,1537,Male,Sarawak,14,8,8,1,31,35,66,B
2015,1538,Female,Malacca,14,5,10,5,34,38,72,B
2014,1539,Male,Pahang,14,3,8,1,26,24,50,C
2015,1540,Female,Perak,17,7,7,5,36,22,58,C
2019,1541,Male,Perlis,20,8,5,3,36,33,69,B
2016,1542,Female,Kelantan,13,7,6,1,27,26,53,C
2018,1543,Male,Negeri Sembilan,15,5,6,1,27,23,50,C
2013,1544,Male,Kelantan,20,5,7,1,33,32,65,B
2016,1545,Male,Perlis,16,10,4,4,34,29,63,B
2019,1546,Female,Negeri Sembilan,16,8,7,5,36,23,59,C
2017,1547,Male,Kedah,15,5,4,4,28,40,68,B
2018,1548,Male,Kedah,16,6,3,1,26,39,65,B
2017,1549,Female,Negeri Sembilan,19,4,6,1,30,27,57,C
2012,1550,Female,Johor,14,10,5,5,34,35,69,B
2019,1551,Female,Sarawak,21,8,10,2,41,40,81,A
2012,1552,Male,Malacca,15,9,4,4,32,23,55,C
2018,1553,Female,Selangor,17,8,8,3,36,23,59,C
2015,1554,Male,Malacca,21,5,4,3,33,22,55,C
2019,1555,Male,Kedah,17,3,8,5,33,36,69,B
2018,1556,Male,Selangor,14,9,8,5,36,29,65,B
2018,1557,Female,Sabah,15,3,8,2,28,22,50,C
2012,1558,Male,Sarawak,13,8,10,2,33,38,71,B
2015,1559,Female,Terengganu,16,10,6,3,35,36,71,B
2012,1560,Female,Penang,16,8,3,1,28,29,57,C
2016,1561,Female,Kedah,21,8,8,4,41,24,65,B
2017,1562,Female,Kelantan,18,5,3,1,27,27,54,C
2014,1563,Male,Pahang,16,4,8,5,33,38,71,B
2015,1564,Male,Sabah,19,9,10,5,43,30,73,B
2014,1565,Male,Johor,20,3,7,4,34,35,69,B
2013,1566,Male,Pahang,14,4,8,5,31,36,67,B
2018,1567,Female,Johor,16,10,8,3,37,23,60,B
2017,1568,Female,Johor,21,10,7,4,42,34,76,B
2016,1569,Male,Kedah,19,8,5,5,37,30,67,B
2014,1570,Male,Penang,14,8,6,3,31,34,65,B
2016,1571,Female,Malacca,16,7,5,1,29,39,68,B
2019,1572,Male,Malacca,16,8,4,1,29,26,55,C
2014,1573,Female,Sabah,15,6,10,1,32,34,66,B
2015,1574,Female,Sarawak,18,7,10,1,36,24,60,B
2012,1575,Female,Negeri Sembilan,15,9,8,4,36,29,65,B
2014,1576,Male,Perak,20,9,3,2,34,28,62,B
2015,1577,Female,Negeri Sembilan,17,5,9,3,34,31,65,B
2016,1578,Male,Negeri Sembilan,21,4,8,1,34,38,72,B
2012,1579,Female,Johor,13,5,8,4,30,36,66,B
2016,1580,Female,Sarawak,14,5,3,4,26,28,54,C
2013,1581,Male,Perlis,16,10,8,2,36,23,59,C
2017,1582,Male,Malacca,16,5,3,5,29,32,61,B
2016,1583,Female,Sabah,14,5,4,3,26,23,49,F
2017,1584,Male,Penang,13,10,10,4,37,39,76,B
2017,1585,Male,Kedah,16,3,6,3,28,34,62,B
2012,1586,Female,Kelantan,16,3,6,4,29,23,52,C
2018,1587,Female,Negeri Sembilan,19,5,9,3,36,25,61,B
2015,1588,Male,Kelantan,18,4,6,5,33,35,68,B
2014,1589,Female,Malacca,17,9,7,3,36,30,66,B
2013,1590,Female,Perak,14,9,9,5,37,24,61,B
2013,1591,Female,Penang,18,10,10,5,43,30,73,B
2013,1592,Female,Perlis,20,6,7,3,36,31,67,B
2013,1593,Male,Sabah,19,9,5,3,36,25,61,B
2019,1594,Male,Perak,19,10,3,3,35,33,68,B
2017,1595,Female,Pahang,20,6,5,3,34,37,71,B
2016,1596,Male,Malacca,14,3,8,5,30,23,53,C
2012,1597,Female,Selangor,17,4,5,4,30,40,70,B
2014,1598,Female,Pahang,18,3,9,5,35,26,61,B
2019,1599,Female,Perlis,16,10,5,1,32,30,62,B
2012,1600,Male,Kelantan,15,5,5,5,30,36,66,B
2014,1601,Female,Negeri Sembilan,13,10,3,4,30,40,70,B
2015,1602,Male,Johor,18,6,6,5,35,26,61,B
2014,1603,Male,Terengganu,19,3,3,1,26,37,63,B
2014,1604,Male,Negeri Sembilan,13,4,9,2,28,31,59,C
2014,1605,Male,Johor,16,3,3,4,26,30,56,C
2018,1606,Male,Pahang,20,10,9,2,41,32,73,B
2016,1607,Female,Negeri Sembilan,20,5,9,1,35,30,65,B
2014,1608,Male,Penang,15,7,3,5,30,37,67,B
2013,1609,Female,Sarawak,13,3,6,5,27,34,61,B
2017,1610,Female,Johor,18,4,3,1,26,27,53,C
2013,1611,Female,Malacca,20,7,10,4,41,30,71,B
2018,1612,Male,Perak,19,10,3,4,36,38,74,B
2017,1613,Male,Kedah,18,9,7,4,38,34,72,B
2019,1614,Male,Kelantan,20,5,7,1,33,26,59,C
2015,1615,Female,Perlis,15,9,8,2,34,22,56,C
2019,1616,Female,Sabah,13,4,8,1,26,25,51,C
2014,1617,Male,Perak,14,8,8,2,32,34,66,B
2019,1618,Female,Sarawak,21,9,6,2,38,28,66,B
2017,1619,Male,Sabah,16,3,10,1,30,29,59,C
2015,1620,Female,Perak,20,3,4,3,30,22,52,C
2014,1621,Male,Negeri Sembilan,14,3,7,1,25,28,53,C
2015,1622,Female,Perak,18,5,5,5,33,27,60,B
2017,1623,Female,Perlis,16,10,9,1,36,40,76,B
2017,1624,Female,Selangor,15,9,4,1,29,35,64,B
2017,1625,Female,Kedah,18,3,4,3,28,30,58,C
2019,1626,Male,Malacca,14,10,9,5,38,28,66,B
2019,1627,Female,Selangor,16,3,4,5,28,34,62,B
2012,1628,Female,Terengganu,17,8,6,4,35,29,64,B
2013,1629,Female,Terengganu,21,6,9,1,37,22,59,C
2012,1630,Female,Perak,14,10,6,5,35,24,59,C
2017,1631,Female,Terengganu,16,6,3,5,30,24,54,C
2015,1632,Male,Selangor,13,7,3,4,27,38,65,B
2017,1633,Male,Kelantan,14,10,9,4,37,23,60,B
2014,1634,Male,Sabah,21,6,4,3,34,25,59,C
2018,1635,Female,Sabah,14,3,5,3,25,39,64,B
2014,1636,Male,Kelantan,21,3,9,1,34,29,63,B
2019,1637,Male,Johor,21,5,9,5,40,36,76,B
2013,1638,Female,Perlis,17,10,8,3,38,33,71,B
2018,1639,Female,Perak,21,5,5,3,34,37,71,B
2015,1640,Female,Kelantan,18,7,6,1,32,38,70,B
2017,1641,Female,Kedah,18,9,9,5,41,22,63,B
2012,1642,Male,Negeri Sembilan,19,4,6,2,31,33,64,B
2016,1643,Female,Johor,17,8,10,5,40,26,66,B
2018,1644,Female,Negeri Sembilan,19,6,10,2,37,40,77,B
2019,1645,Female,Pahang,19,6,9,4,38,30,68,B
2014,1646,Male,Terengganu,19,4,6,1,30,36,66,B
2013,1647,Female,Terengganu,14,3,7,4,28,28,56,C
2015,1648,Male,Kelantan,21,9,7,1,38,34,72,B
2012,1649,Female,Sabah,18,6,6,2,32,39,71,B
2017,1650,Female,Selangor,20,6,5,2,33,30,63,B
2016,1651,Male,Johor,14,8,7,4,33,28,61,B
2014,1652,Male,Penang,19,3,10,3,35,36,71,B
2015,1653,Male,Kedah,17,10,5,4,36,35,71,B
2016,1654,Female,Negeri Sembilan,21,6,5,3,35,28,63,B
2014,1655,Female,Kedah,16,10,3,4,33,36,69,B
2015,1656,Male,Johor,14,9,5,5,33,40,73,B
2012,1657,Female,Kedah,14,8,5,2,29,27,56,C
2018,1658,Female,Perak,16,3,7,2,28,40,68,B
2013,1659,Female,Perlis,18,8,3,4,33,34,67,B
2017,1660,Female,Johor,14,6,4,1,25,29,54,C
2017,1661,Female,Sarawak,17,6,3,1,27,33,60,B
2017,1662,Female,Selangor,14,7,6,2,29,40,69,B
2015,1663,Female,Malacca,19,6,9,5,39,34,73,B
2014,1664,Female,Perlis,13,9,6,3,31,39,70,B
2019,1665,Male,Terengganu,14,10,4,2,30,23,53,C
2013,1666,Female,Sabah,18,6,3,4,31,26,57,C
2013,1667,Female,Penang,13,9,5,5,32,29,61,B
2018,1668,Female,Malacca,19,3,7,1,30,23,53,C
2014,1669,Female,Pahang,21,4,6,4,35,22,57,C
2018,1670,Female,Negeri Sembilan,15,10,6,2,33,32,65,B
2016,1671,Male,Sarawak,18,7,7,5,37,25,62,B
2014,1672,Female,Negeri Sembilan,16,3,8,5,32,25,57,C
2017,1673,Male,Kedah,13,7,6,1,27,24,51,C
2015,1674,Male,Kedah,20,5,5,5,35,31,66,B
2014,1675,Male,Kelantan,14,10,4,2,30,36,66,B
2019,1676,Male,Kelantan,17,6,9,3,35,29,64,B
2015,1677,Male,Negeri Sembilan,17,9,10,2,38,24,62,B
2016,1678,Female,Perak,16,5,5,3,29,37,66,B
2017,1679,Female,Selangor,17,7,8,4,36,33,69,B
2014,1680,Female,Johor,20,9,6,1,36,35,71,B
2019,1681,Male,Sabah,17,4,5,5,31,23,54,C
2018,1682,Female,Negeri Sembilan,13,5,5,3,26,39,65,B
2018,1683,Female,Johor,20,8,3,4,35,31,66,B
2018,1684,Female,Johor,19,5,6,3,33,40,73,B
2019,1685,Male,Kedah,14,9,10,4,37,24,61,B
2015,1686,Female,Malacca,21,4,9,5,39,35,74,B
2018,1687,Male,Malacca,17,9,6,2,34,26,60,B
2018,1688,Female,Malacca,13,10,6,2,31,25,56,C
2019,1689,Female,Sabah,14,10,8,4,36,34,70,B
2018,1690,Female,Sarawak,17,9,5,2,33,34,67,B
2015,1691,Male,Sabah,13,10,5,4,32,30,62,B
2014,1692,Female,Perak,16,3,10,4,33,40,73,B
2016,1693,Female,Johor,19,9,9,3,40,25,65,B
2013,1694,Male,Malacca,16,4,4,1,25,35,60,B
2017,1695,Female,Kedah,21,10,8,4,43,24,67,B
2018,1696,Male,Kelantan,14,3,3,4,24,38,62,B
2017,1697,Male,Sarawak,14,6,3,5,28,24,52,C
2012,1698,Female,Johor,18,9,5,4,36,38,74,B
2013,1699,Female,Perlis,19,8,3,5,35,25,60,B
2018,1700,Male,Sabah,15,7,10,2,34,24,58,C
2018,1701,Female,Johor,18,5,3,5,31,31,62,B
2014,1702,Male,Terengganu,20,3,8,4,35,26,61,B
2019,1703,Male,Selangor,17,5,3,2,27,34,61,B
2013,1704,Male,Sarawak,18,6,9,2,35,25,60,B
2014,1705,Male,Sabah,21,8,9,2,40,37,77,B
2012,1706,Male,Perlis,17,7,3,4,31,24,55,C
2017,1707,Male,Johor,17,8,4,5,34,38,72,B
2015,1708,Female,Negeri Sembilan,13,9,10,1,33,31,64,B
2019,1709,Female,Sarawak,17,3,4,3,27,30,57,C
2016,1710,Female,Penang,16,6,5,3,30,23,53,C
2019,1711,Female,Selangor,20,8,7,5,40,28,68,B
2016,1712,Male,Perak,20,3,7,2,32,38,70,B
2016,1713,Female,Selangor,17,7,10,3,37,39,76,B
2016,1714,Male,Sabah,18,10,6,1,35,29,64,B
2017,1715,Female,Selangor,19,7,9,5,40,32,72,B
2019,1716,Female,Terengganu,18,3,4,3,28,22,50,C
2019,1717,Female,Selangor,18,6,9,3,36,37,73,B
2015,1718,Male,Pahang,15,6,6,5,32,32,64,B
2016,1719,Male,Pahang,18,7,10,1,36,25,61,B
2016,1720,Female,Perak,18,3,7,3,31,33,64,B
2014,1721,Female,Selangor,19,4,5,5,33,25,58,C
2014,1722,Female,Kelantan,19,7,4,4,34,40,74,B
2015,1723,Female,Perak,13,7,3,5,28,32,60,B
2015,1724,Male,Malacca,15,3,9,1,28,25,53,C
2015,1725,Male,Kedah,21,3,7,4,35,31,66,B
2017,1726,Male,Malacca,14,4,3,2,23,33,56,C
2018,1727,Female,Sabah,19,9,7,4,39,38,77,B
2012,1728,Male,Negeri Sembilan,13,4,9,3,29,38,67,B
2013,1729,Female,Kelantan,19,7,9,2,37,36,73,B
2015,1730,Male,Kedah,19,5,9,1,34,32,66,B
2014,1731,Male,Selangor,19,10,8,3,40,38,78,B
2019,1732,Female,Pahang,18,7,3,5,33,33,66,B
2013,1733,Male,Pahang,14,8,5,4,31,40,71,B
2018,1734,Female,Sabah,16,9,5,2,32,24,56,C
2013,1735,Female,Malacca,18,3,7,1,29,22,51,C
2016,1736,Male,Perlis,18,5,9,4,36,26,62,B
2015,1737,Female,Pahang,19,4,8,5,36,25,61,B
2016,1738,Male,Selangor,19,3,5,5,32,25,57,C
2019,1739,Female,Pahang,17,3,10,4,34,28,62,B
2013,1740,Male,Kelantan,14,4,4,5,27,34,61,B
2018,1741,Female,Sabah,15,9,10,3,37,30,67,B
2013,1742,Male,Kelantan,18,8,5,3,34,38,72,B
2015,1743,Female,Pahang,20,6,8,3,37,25,62,B
2014,1744,Male,Sarawak,14,3,3,5,25,28,53,C
2013,1745,Female,Perlis,17,7,6,3,33,39,72,B
2019,1746,Female,Pahang,18,8,9,2,37,39,76,B
2014,1747,Male,Selangor,20,3,10,5,38,22,60,B
2013,1748,Female,Negeri Sembilan,17,3,3,4,27,27,54,C
2016,1749,Female,Terengganu,19,10,7,1,37,35,72,B
2012,1750,Male,Sarawak,17,6,5,2,30,33,63,B
2013,1751,Male,Penang,21,5,9,1,36,26,62,B
2012,1752,Female,Pahang,16,5,8,3,32,23,55,C
2019,1753,Male,Sarawak,15,4,5,5,29,31,60,B
2019,1754,Female,Pahang,21,8,10,3,42,32,74,B
2013,1755,Female,Perlis,21,8,10,1,40,36,76,B
2018,1756,Male,Pahang,15,10,10,3,38,30,68,B
2016,1757,Female,Johor,18,7,3,2,30,39,69,B
2013,1758,Female,Malacca,16,5,9,3,33,36,69,B
2017,1759,Male,Kelantan,16,8,6,5,35,26,61,B
2018,1760,Male,Perak,15,3,10,1,29,33,62,B
2017,1761,Male,Sabah,15,8,6,4,33,38,71,B
2013,1762,Female,Kedah,21,4,10,3,38,26,64,B
2018,1763,Female,Malacca,20,3,10,4,37,30,67,B
2015,1764,Male,Negeri Sembilan,21,8,6,3,38,36,74,B
2014,1765,Female,Johor,19,5,6,1,31,37,68,B
2014,1766,Female,Kedah,15,9,10,5,39,39,78,B
2016,1767,Male,Malacca,18,5,4,5,32,32,64,B
2018,1768,Male,Selangor,13,7,7,4,31,30,61,B
2013,1769,Male,Negeri Sembilan,20,8,9,3,40,39,79,A
2018,1770,Male,Perak,15,6,6,2,29,29,58,C
2015,1771,Female,Terengganu,18,6,9,2,35,32,67,B
2013,1772,Male,Sarawak,19,3,7,5,34,22,56,C
2017,1773,Male,Selangor,16,8,10,5,39,26,65,B
2017,1774,Male,Malacca,14,6,5,5,30,26,56,C
2019,1775,Female,Negeri Sembilan,16,4,9,5,34,26,60,B
2018,1776,Male,Penang,13,3,7,2,25,34,59,C
2018,1777,Female,Sabah,21,6,6,5,38,23,61,B
2013,1778,Female,Malacca,21,4,4,3,32,29,61,B
2015,1779,Male,Kedah,15,8,8,5,36,27,63,B
2014,1780,Female,Perak,18,9,9,5,41,22,63,B
2014,1781,Female,Penang,19,10,5,1,35,22,57,C
2019,1782,Female,Johor,14,7,7,2,30,25,55,C
2017,1783,Female,Negeri Sembilan,15,3,5,4,27,28,55,C
2014,1784,Female,Perak,14,10,8,3,35,36,71,B
2018,1785,Female,Perlis,14,6,6,2,28,26,54,C
2019,1786,Female,Sabah,16,8,8,1,33,38,71,B
2018,1787,Female,Selangor,20,4,3,5,32,32,64,B
2018,1788,Male,Selangor,15,10,9,5,39,22,61,B
2017,1789,Female,Sabah,15,8,9,3,35,35,70,B
2012,1790,Male,Sabah,20,8,6,4,38,27,65,B
2013,1791,Male,Sarawak,13,5,4,2,24,23,47,F
2019,1792,Male,Perak,17,6,10,2,35,26,61,B
2015,1793,Female,Perak,19,8,8,5,40,26,66,B
2016,1794,Male,Negeri Sembilan,15,4,8,2,29,38,67,B
2012,1795,Male,Penang,16,6,10,3,35,39,74,B
2017,1796,Male,Negeri Sembilan,15,8,7,4,34,25,59,C
2015,1797,Female,Negeri Sembilan,13,5,9,4,31,28,59,C
2018,1798,Female,Kedah,18,4,10,3,35,25,60,B
2015,1799,Female,Penang,17,7,8,2,34,26,60,B
2019,1800,Male,Terengganu,19,4,9,5,37,37,74,B
2012,1801,Male,Selangor,16,3,4,3,26,29,55,C
2013,1802,Female,Pahang,21,9,4,5,39,33,72,B
2012,1803,Female,Kelantan,13,7,6,1,27,40,67,B
2012,1804,Female,Malacca,21,5,4,2,32,23,55,C
2018,1805,Female,Sabah,14,9,9,3,35,30,65,B
2019,1806,Female,Pahang,15,8,8,3,34,30,64,B
2017,1807,Male,Terengganu,17,7,8,2,34,23,57,C
2015,1808,Male,Kelantan,15,7,4,5,31,37,68,B
2014,1809,Female,Penang,21,8,4,2,35,40,75,B
2014,1810,Female,Sabah,15,4,6,3,28,37,65,B
2013,1811,Female,Malacca,21,8,10,3,42,36,78,B
2012,1812,Female,Penang,19,9,9,3,40,23,63,B
2017,1813,Female,Malacca,16,5,7,1,29,25,54,C
2016,1814,Female,Johor,18,4,8,1,31,38,69,B
2013,1815,Female,Sarawak,18,5,4,2,29,40,69,B
2017,1816,Female,Perak,21,3,10,3,37,22,59,C
2012,1817,Male,Perak,16,3,4,1,24,23,47,F
2013,1818,Male,Sabah,14,10,9,2,35,38,73,B
2012,1819,Female,Penang,18,4,3,2,27,25,52,C
2016,1820,Male,Penang,20,8,3,2,33,26,59,C
2019,1821,Male,Pahang,14,9,3,4,30,34,64,B
2019,1822,Female,Sabah,20,4,10,5,39,27,66,B
2017,1823,Female,Sabah,14,5,3,5,27,34,61,B
2019,1824,Male,Sabah,15,6,4,4,29,33,62,B
2018,1825,Female,Selangor,14,5,8,5,32,35,67,B
2019,1826,Female,Negeri Sembilan,15,10,6,4,35,30,65,B
2019,1827,Female,Penang,13,9,4,2,28,37,65,B
2016,1828,Male,Sabah,15,8,7,4,34,28,62,B
2016,1829,Male,Perlis,21,3,7,4,35,37,72,B
2014,1830,Female,Pahang,20,3,4,4,31,34,65,B
2018,1831,Male,Malacca,15,5,6,4,30,33,63,B
2015,1832,Female,Pahang,14,7,4,1,26,33,59,C
2014,1833,Male,Sabah,19,3,10,4,36,23,59,C
2015,1834,Female,Kelantan,16,3,9,2,30,30,60,B
2014,1835,Male,Selangor,21,10,7,1,39,36,75,B
2012,1836,Male,Perlis,19,7,6,5,37,23,60,B
2012,1837,Female,Kelantan,18,6,3,1,28,22,50,C
2017,1838,Male,Sarawak,19,6,10,1,36,36,72,B
2019,1839,Female,Penang,19,10,9,5,43,29,72,B
2013,1840,Female,Terengganu,13,9,7,1,30,30,60,B
2012,1841,Female,Sarawak,13,9,10,5,37,22,59,C
2015,1842,Female,Johor,16,9,5,5,35,26,61,B
2016,1843,Female,Malacca,15,6,7,5,33,31,64,B
2014,1844,Female,Terengganu,15,8,8,2,33,25,58,C
2016,1845,Female,Perak,18,8,10,2,38,40,78,B
2013,1846,Male,Perak,19,10,9,3,41,35,76,B
2015,1847,Male,Pahang,15,8,7,3,33,22,55,C
2018,1848,Female,Kelantan,16,6,6,2,30,36,66,B
2015,1849,Male,Terengganu,20,9,8,4,41,27,68,B
2018,1850,Male,Terengganu,20,8,5,3,36,24,60,B
2016,1851,Male,Kedah,21,7,5,4,37,35,72,B
2013,1852,Female,Kelantan,21,5,8,4,38,29,67,B
2019,1853,Male,Pahang,18,3,5,3,29,35,64,B
2016,1854,Male,Sarawak,19,7,8,5,39,23,62,B
2019,1855,Female,Pahang,15,4,3,2,24,39,63,B
2018,1856,Male,Pahang,21,9,10,4,44,37,81,A
2014,1857,Female,Malacca,17,9,10,5,41,24,65,B
2012,1858,Female,Penang,15,9,10,5,39,30,69,B
2017,1859,Male,Johor,20,10,5,4,39,40,79,A
2017,1860,Male,Negeri Sembilan,16,9,9,4,38,30,68,B
2015,1861,Male,Perak,13,4,5,5,27,25,52,C
2016,1862,Female,Pahang,13,6,4,3,26,32,58,C
2012,1863,Male,Selangor,17,3,3,5,28,24,52,C
2013,1864,Male,Perak,16,4,8,5,33,40,73,B
2012,1865,Male,Selangor,19,8,5,2,34,32,66,B
2019,1866,Male,Malacca,13,9,10,3,35,25,60,B
2016,1867,Female,Terengganu,19,9,3,1,32,29,61,B
2019,1868,Male,Perak,19,4,4,3,30,32,62,B
2017,1869,Male,Pahang,18,3,9,3,33,34,67,B
2017,1870,Male,Pahang,19,7,9,5,40,32,72,B
2012,1871,Male,Johor,14,7,10,3,34,26,60,B
2013,1872,Male,Selangor,20,10,9,2,41,38,79,A
2018,1873,Female,Pahang,21,5,4,4,34,25,59,C
2013,1874,Male,Selangor,18,6,9,2,35,27,62,B
2018,1875,Female,Sabah,18,7,6,3,34,32,66,B
2016,1876,Female,Kelantan,20,5,10,1,36,24,60,B
2012,1877,Female,Malacca,18,3,5,2,28,30,58,C
2015,1878,Male,Perlis,18,3,6,5,32,24,56,C
2012,1879,Male,Kedah,21,5,8,5,39,23,62,B
2016,1880,Male,Pahang,21,7,4,4,36,35,71,B
2012,1881,Male,Sarawak,19,10,8,2,39,40,79,A
2013,1882,Male,Malacca,16,10,7,4,37,37,74,B
2012,1883,Female,Kelantan,16,6,3,3,28,26,54,C
2013,1884,Male,Sabah,18,5,10,2,35,30,65,B
2017,1885,Male,Kedah,17,6,6,5,34,35,69,B
2016,1886,Male,Sabah,15,4,5,2,26,29,55,C
2019,1887,Male,Malacca,20,5,7,2,34,25,59,C
2019,1888,Female,Terengganu,18,5,6,2,31,35,66,B
2014,1889,Female,Negeri Sembilan,20,3,4,1,28,25,53,C
2013,1890,Female,Johor,13,7,7,4,31,22,53,C
2019,1891,Male,Kedah,19,8,6,5,38,24,62,B
2012,1892,Female,Perlis,16,4,5,4,29,23,52,C
2014,1893,Male,Johor,19,9,8,5,41,38,79,A
2016,1894,Female,Negeri Sembilan,19,8,4,3,34,31,65,B
2012,1895,Male,Negeri Sembilan,17,6,10,3,36,34,70,B
2016,1896,Male,Malacca,14,7,5,4,30,34,64,B
2017,1897,Male,Kelantan,14,4,7,1,26,40,66,B
2013,1898,Male,Pahang,21,9,8,5,43,39,82,A
2018,1899,Female,Penang,17,5,7,4,33,23,56,C
2019,1900,Female,Johor,20,6,3,2,31,34,65,B
2014,1901,Female,Pahang,18,8,8,5,39,36,75,B
2018,1902,Female,Perak,19,3,10,4,36,33,69,B
2014,1903,Female,Sabah,17,5,8,2,32,32,64,B
2012,1904,Male,Sabah,17,8,5,5,35,28,63,B
2012,1905,Male,Kelantan,21,7,4,1,33,39,72,B
2015,1906,Female,Johor,19,7,6,4,36,40,76,B
2019,1907,Female,Pahang,18,4,4,2,28,34,62,B
2018,1908,Female,Terengganu,17,7,4,3,31,24,55,C
2015,1909,Female,Sarawak,20,7,3,5,35,34,69,B
2014,1910,Female,Negeri Sembilan,20,6,9,2,37,33,70,B
2015,1911,Female,Terengganu,20,3,6,1,30,22,52,C
2017,1912,Female,Malacca,21,4,9,2,36,39,75,B
2013,1913,Male,Sarawak,14,4,10,4,32,34,66,B
2012,1914,Male,Negeri Sembilan,15,5,3,1,24,30,54,C
2015,1915,Female,Terengganu,21,3,10,5,39,39,78,B
2018,1916,Male,Pahang,19,5,7,3,34,36,70,B
2017,1917,Female,Kelantan,15,6,9,4,34,27,61,B
2017,1918,Female,Perak,20,10,8,1,39,33,72,B
2016,1919,Female,Selangor,14,8,3,4,29,27,56,C
2014,1920,Female,Perlis,18,8,9,1,36,28,64,B
2017,1921,Male,Pahang,20,4,10,5,39,38,77,B
2014,1922,Female,Perlis,13,4,7,3,27,25,52,C
2018,1923,Male,Kelantan,16,10,7,2,35,30,65,B
2012,1924,Male,Terengganu,21,8,5,2,36,40,76,B
2013,1925,Female,Perlis,14,6,8,2,30,36,66,B
2019,1926,Female,Perlis,18,4,4,1,27,38,65,B
2014,1927,Female,Negeri Sembilan,21,4,3,1,29,40,69,B
2012,1928,Male,Pahang,13,4,7,5,29,35,64,B
2014,1929,Male,Sabah,20,9,4,2,35,35,70,B
2015,1930,Female,Johor,18,9,8,4,39,30,69,B
2019,1931,Female,Pahang,21,7,3,3,34,37,71,B
2015,1932,Female,Negeri Sembilan,17,4,10,4,35,31,66,B
2019,1933,Male,Kedah,17,10,10,2,39,27,66,B
2018,1934,Female,Terengganu,19,10,5,2,36,25,61,B
2012,1935,Female,Kedah,13,4,5,1,23,24,47,F
2017,1936,Male,Kedah,18,3,7,5,33,32,65,B
2015,1937,Female,Johor,13,7,9,2,31,23,54,C
2013,1938,Male,Sarawak,17,7,10,4,38,32,70,B
2016,1939,Female,Johor,16,5,6,5,32,35,67,B
2018,1940,Female,Johor,19,9,3,4,35,40,75,B
2013,1941,Female,Perlis,14,6,7,1,28,25,53,C
2013,1942,Male,Johor,17,7,7,3,34,24,58,C
2019,1943,Male,Kelantan,17,10,8,3,38,34,72,B
2019,1944,Female,Kedah,14,8,4,5,31,40,71,B
2019,1945,Male,Sarawak,17,8,5,2,32,31,63,B
2012,1946,Male,Malacca,18,6,3,2,29,27,56,C
2017,1947,Male,Pahang,19,4,9,5,37,22,59,C
2014,1948,Female,Perlis,13,3,3,3,22,36,58,C
2019,1949,Female,Selangor,14,4,4,1,23,34,57,C
2015,1950,Male,Pahang,13,4,8,4,29,40,69,B
2017,1951,Male,Penang,15,7,3,2,27,34,61,B
2018,1952,Male,Terengganu,16,4,7,2,29,35,64,B
2012,1953,Female,Negeri Sembilan,13,7,10,3,33,25,58,C
2015,1954,Male,Johor,19,5,10,5,39,34,73,B
2012,1955,Male,Kedah,15,3,5,3,26,28,54,C
2012,1956,Male,Selangor,17,10,7,5,39,40,79,A
2013,1957,Male,Malacca,17,7,3,5,32,38,70,B
2016,1958,Male,Perak,15,8,10,3,36,29,65,B
2017,1959,Female,Kedah,20,10,9,5,44,39,83,A
2015,1960,Female,Johor,19,6,6,1,32,40,72,B
2014,1961,Female,Kedah,13,6,4,4,27,36,63,B
2018,1962,Female,Pahang,20,6,6,1,33,31,64,B
2018,1963,Male,Sarawak,19,4,5,5,33,33,66,B
2019,1964,Male,Negeri Sembilan,21,7,3,1,32,38,70,B
2016,1965,Female,Selangor,13,3,10,3,29,36,65,B
2013,1966,Male,Malacca,19,10,10,2,41,23,64,B
2014,1967,Male,Malacca,14,5,3,5,27,39,66,B
2018,1968,Male,Selangor,13,5,7,3,28,35,63,B
2018,1969,Female,Perlis,15,5,7,1,28,29,57,C
2016,1970,Female,Malacca,20,5,8,1,34,29,63,B
2018,1971,Male,Selangor,15,5,5,1,26,39,65,B
2019,1972,Female,Penang,20,6,8,5,39,39,78,B
2015,1973,Female,Negeri Sembilan,13,7,6,1,27,24,51,C
2017,1974,Female,Sarawak,16,10,8,4,38,31,69,B
2013,1975,Female,Perak,15,5,3,5,28,38,66,B
2017,1976,Female,Kelantan,19,7,3,1,30,26,56,C
2016,1977,Female,Sarawak,15,6,5,2,28,39,67,B
2014,1978,Female,Selangor,14,6,4,3,27,24,51,C
2012,1979,Male,Perak,15,6,9,1,31,30,61,B
2012,1980,Female,Kedah,20,6,4,4,34,26,60,B
2019,1981,Male,Selangor,17,6,6,2,31,34,65,B
2013,1982,Female,Penang,18,7,4,5,34,40,74,B
2019,1983,Female,Sarawak,21,5,10,4,40,26,66,B
2017,1984,Male,Negeri Sembilan,16,8,7,2,33,24,57,C
2014,1985,Male,Johor,17,6,6,3,32,36,68,B
2013,1986,Female,Terengganu,17,10,6,4,37,29,66,B
2016,1987,Female,Malacca,13,8,9,5,35,36,71,B
2018,1988,Female,Sabah,14,4,7,5,30,38,68,B
2013,1989,Female,Pahang,21,3,4,4,32,29,61,B
2015,1990,Male,Malacca,18,4,10,1,33,26,59,C
2017,1991,Female,Kelantan,19,8,10,4,41,23,64,B
2015,1992,Male,Kelantan,21,6,6,1,34,30,64,B
2012,1993,Female,Johor,19,9,7,1,36,31,67,B
2014,1994,Male,Johor,16,9,4,3,32,30,62,B
2019,1995,Male,Negeri Sembilan,15,3,6,5,29,23,52,C
2018,1996,Male,Terengganu,15,5,7,2,29,25,54,C
2019,1997,Male,Selangor,18,8,4,5,35,39,74,B
2013,1998,Female,Perak,21,4,6,1,32,28,60,B
2013,1999,Female,Sarawak,16,7,10,1,34,30,64,B
2012,2000,Female,Kelantan,13,4,5,5,27,30,57,C
2014,2001,Male,Malacca,20,4,8,2,34,29,63,B
2014,2002,Male,Negeri Sembilan,13,9,7,4,33,25,58,C
2015,2003,Male,Penang,14,10,10,1,35,31,66,B
2014,2004,Female,Kelantan,15,6,5,3,29,24,53,C
2017,2005,Female,Pahang,19,4,10,2,35,32,67,B
2017,2006,Female,Johor,16,10,3,5,34,26,60,B
2016,2007,Female,Perak,17,5,3,1,26,33,59,C
2014,2008,Female,Penang,20,3,8,3,34,31,65,B
2017,2009,Female,Malacca,21,5,6,4,36,32,68,B
2015,2010,Female,Terengganu,21,6,9,3,39,32,71,B
2017,2011,Female,Sarawak,18,6,3,4,31,25,56,C
2015,2012,Female,Negeri Sembilan,21,9,8,2,40,22,62,B
2016,2013,Male,Kelantan,15,5,3,4,27,40,67,B
2014,2014,Female,Sarawak,13,3,9,1,26,24,50,C
2015,2015,Male,Malacca,15,3,3,3,24,22,46,F
2018,2016,Male,Pahang,14,9,5,5,33,28,61,B
2016,2017,Male,Sarawak,21,9,7,5,42,34,76,B
2014,2018,Male,Kelantan,21,5,8,5,39,28,67,B
2013,2019,Male,Johor,17,7,9,2,35,22,57,C
2014,2020,Male,Sabah,15,5,3,5,28,37,65,B
2016,2021,Male,Sabah,16,5,4,5,30,36,66,B
2019,2022,Female,Kelantan,20,8,3,3,34,25,59,C
2018,2023,Female,Perak,15,3,8,3,29,22,51,C
2012,2024,Female,Kelantan,17,5,7,1,30,36,66,B
2018,2025,Female,Perlis,17,6,9,3,35,33,68,B
2014,2026,Female,Johor,13,10,9,1,33,24,57,C
2015,2027,Female,Sabah,16,7,4,3,30,23,53,C
2014,2028,Male,Perlis,17,5,10,4,36,28,64,B
2016,2029,Male,Kedah,20,9,8,2,39,25,64,B
2019,2030,Female,Terengganu,17,9,8,4,38,28,66,B
2019,2031,Male,Kelantan,16,5,8,3,32,33,65,B
2015,2032,Male,Sarawak,13,7,3,5,28,36,64,B
2017,2033,Male,Johor,21,9,3,4,37,34,71,B
2013,2034,Female,Terengganu,16,6,3,2,27,24,51,C
2013,2035,Male,Johor,20,4,5,5,34,25,59,C
2012,2036,Male,Malacca,15,3,6,5,29,24,53,C
2014,2037,Male,Penang,20,10,5,5,40,30,70,B
2016,2038,Female,Penang,17,7,5,4,33,24,57,C
2012,2039,Male,Malacca,16,3,7,2,28,30,58,C
2013,2040,Female,Malacca,17,3,4,2,26,36,62,B
2012,2041,Female,Perak,16,10,9,5,40,26,66,B
2019,2042,Female,Terengganu,18,8,5,3,34,25,59,C
2013,2043,Female,Sabah,20,10,5,4,39,31,70,B
2015,2044,Female,Kelantan,17,9,8,2,36,38,74,B
2015,2045,Male,Kedah,15,4,3,2,24,30,54,C
2017,2046,Female,Perlis,21,5,3,4,33,22,55,C
2014,2047,Female,Pahang,20,5,7,5,37,39,76,B
2014,2048,Female,Perak,14,4,4,1,23,40,63,B
2016,2049,Female,Malacca,16,3,7,1,27,29,56,C
2015,2050,Male,Penang,20,8,5,1,34,27,61,B
2012,2051,Male,Negeri Sembilan,14,10,6,4,34,37,71,B
2015,2052,Female,Perak,16,9,6,2,33,27,60,B
2015,2053,Male,Penang,17,5,3,1,26,36,62,B
2016,2054,Male,Negeri Sembilan,16,8,6,1,31,28,59,C
2018,2055,Male,Perlis,17,5,10,1,33,24,57,C
2019,2056,Female,Negeri Sembilan,21,5,3,3,32,29,61,B
2012,2057,Female,Pahang,18,8,5,1,32,32,64,B
2015,2058,Male,Penang,19,7,8,4,38,25,63,B
2017,2059,Male,Johor,19,4,3,2,28,29,57,C
2018,2060,Female,Perak,21,3,9,4,37,22,59,C
2013,2061,Male,Perlis,13,6,7,5,31,27,58,C
2013,2062,Female,Pahang,14,10,9,4,37,24,61,B
2018,2063,Female,Selangor,14,3,9,1,27,34,61,B
2018,2064,Female,Negeri Sembilan,19,7,3,5,34,23,57,C
2014,2065,Male,Sabah,16,5,6,4,31,32,63,B
2019,2066,Female,Terengganu,16,4,5,5,30,27,57,C
2015,2067,Female,Johor,13,3,3,4,23,28,51,C
2012,2068,Female,Perlis,16,6,5,4,31,32,63,B
2019,2069,Male,Sarawak,16,5,6,4,31,38,69,B
2018,2070,Female,Penang,20,9,7,4,40,38,78,B
2014,2071,Male,Selangor,21,4,8,4,37,26,63,B
2013,2072,Male,Pahang,17,7,8,4,36,39,75,B
2018,2073,Female,Penang,16,10,5,4,35,22,57,C
2013,2074,Male,Perlis,17,6,7,5,35,31,66,B
2019,2075,Female,Malacca,19,8,4,2,33,23,56,C
2015,2076,Male,Sabah,18,6,4,1,29,31,60,B
2014,2077,Female,Perak,14,7,9,2,32,30,62,B
2013,2078,Female,Kedah,21,8,6,4,39,40,79,A
2012,2079,Male,Sarawak,20,10,9,3,42,24,66,B
2018,2080,Female,Malacca,21,4,10,3,38,22,60,B
2012,2081,Female,Sabah,13,6,10,5,34,24,58,C
2019,2082,Male,Kelantan,14,9,3,2,28,38,66,B
2016,2083,Female,Johor,17,6,9,1,33,33,66,B
2018,2084,Male,Kelantan,19,4,10,5,38,33,71,B
2015,2085,Male,Selangor,21,8,3,5,37,40,77,B
2015,2086,Male,Terengganu,18,3,9,3,33,40,73,B
2014,2087,Male,Kedah,20,6,3,4,33,35,68,B
2019,2088,Male,Negeri Sembilan,15,9,7,1,32,24,56,C
2015,2089,Male,Sarawak,16,9,10,1,36,22,58,C
2012,2090,Female,Kedah,16,9,9,1,35,32,67,B
2018,2091,Male,Perlis,21,8,5,5,39,39,78,B
2019,2092,Male,Perlis,20,4,3,4,31,32,63,B
2012,2093,Male,Malacca,21,4,7,2,34,30,64,B
2012,2094,Male,Sarawak,13,5,6,1,25,28,53,C
2012,2095,Female,Sabah,17,4,3,2,26,38,64,B
2018,2096,Male,Sarawak,15,3,8,1,27,32,59,C
2017,2097,Female,Kelantan,16,10,6,2,34,35,69,B
2012,2098,Female,Sabah,16,8,9,4,37,32,69,B
2012,2099,Male,Kedah,15,6,3,4,28,25,53,C
2017,2100,Male,Pahang,15,6,4,5,30,22,52,C
2014,2101,Female,Selangor,14,3,8,5,30,26,56,C
2017,2102,Female,Johor,17,4,3,5,29,29,58,C
2018,2103,Female,Terengganu,16,7,10,4,37,37,74,B
2012,2104,Female,Malacca,19,4,3,4,30,40,70,B
2016,2105,Male,Perlis,17,3,8,4,32,27,59,C
2012,2106,Female,Malacca,17,10,7,3,37,38,75,B
2018,2107,Male,Penang,20,8,6,3,37,33,70,B
2019,2108,Female,Terengganu,17,4,7,5,33,35,68,B
2015,2109,Female,Perlis,21,10,3,2,36,24,60,B
2019,2110,Female,Pahang,20,7,10,3,40,24,64,B
2013,2111,Male,Malacca,17,7,7,4,35,34,69,B
2013,2112,Male,Selangor,16,10,6,1,33,39,72,B
2018,2113,Male,Perak,17,8,3,1,29,38,67,B
2019,2114,Male,Perak,20,9,5,3,37,38,75,B
2016,2115,Female,Sarawak,20,3,10,5,38,31,69,B
2019,2116,Male,Penang,13,3,8,4,28,35,63,B
2016,2117,Female,Terengganu,19,7,5,3,34,34,68,B
2016,2118,Female,Sabah,14,7,8,4,33,38,71,B
2019,2119,Female,Negeri Sembilan,16,6,4,1,27,39,66,B
2018,2120,Male,Terengganu,16,5,4,5,30,26,56,C
2018,2121,Female,Perak,13,7,6,1,27,31,58,C
2015,2122,Female,Terengganu,21,4,4,2,31,40,71,B
2016,2123,Female,Terengganu,18,6,8,1,33,33,66,B
2018,2124,Female,Terengganu,21,9,8,1,39,26,65,B
2013,2125,Female,Sabah,15,3,5,5,28,25,53,C
2019,2126,Female,Perlis,21,9,3,2,35,23,58,C
2016,2127,Male,Terengganu,20,3,9,5,37,31,68,B
2012,2128,Female,Negeri Sembilan,16,4,3,3,26,33,59,C
2019,2129,Female,Perak,21,5,4,5,35,39,74,B
2015,2130,Male,Malacca,19,8,3,2,32,23,55,C
2017,2131,Male,Kelantan,21,4,10,5,40,27,67,B
2015,2132,Female,Perlis,18,7,7,5,37,38,75,B
2016,2133,Female,Malacca,21,4,5,4,34,36,70,B
2018,2134,Female,Johor,20,7,3,4,34,34,68,B
2017,2135,Male,Johor,20,10,9,4,43,39,82,A
2014,2136,Male,Johor,19,8,3,1,31,25,56,C
2017,2137,Male,Terengganu,19,3,5,1,28,36,64,B
2018,2138,Female,Perak,15,7,8,3,33,29,62,B
2018,2139,Male,Penang,17,9,3,4,33,40,73,B
2012,2140,Female,Selangor,15,4,9,4,32,33,65,B
2012,2141,Male,Kelantan,19,9,5,4,37,31,68,B
2016,2142,Male,Negeri Sembilan,13,8,9,3,33,39,72,B
2017,2143,Female,Kelantan,20,8,9,2,39,22,61,B
2015,2144,Female,Pahang,16,4,6,2,28,36,64,B
2014,2145,Female,Perak,14,9,7,1,31,22,53,C
2017,2146,Female,Malacca,17,7,7,2,33,39,72,B
2015,2147,Female,Perak,14,9,8,4,35,31,66,B
2012,2148,Female,Malacca,16,9,9,2,36,29,65,B
2013,2149,Female,Kedah,16,4,6,1,27,40,67,B
2015,2150,Female,Negeri Sembilan,21,5,3,4,33,28,61,B
2017,2151,Female,Pahang,13,5,8,1,27,40,67,B
2018,2152,Male,Johor,15,9,8,5,37,40,77,B
2018,2153,Female,Terengganu,13,5,4,3,25,40,65,B
2013,2154,Female,Perlis,18,4,5,1,28,33,61,B
2019,2155,Male,Negeri Sembilan,21,7,7,3,38,40,78,B
2015,2156,Male,Pahang,14,5,6,3,28,35,63,B
2017,2157,Male,Johor,18,3,4,2,27,39,66,B
2017,2158,Female,Kelantan,16,3,10,5,34,39,73,B
2016,2159,Male,Perlis,20,10,7,2,39,23,62,B
2014,2160,Female,Negeri Sembilan,20,6,8,3,37,31,68,B
2016,2161,Female,Negeri Sembilan,21,8,9,4,42,29,71,B
2017,2162,Female,Sarawak,16,3,9,1,29,32,61,B
2018,2163,Male,Sarawak,18,4,6,3,31,23,54,C
2016,2164,Male,Perak,20,7,9,2,38,31,69,B
2018,2165,Male,Selangor,17,4,5,4,30,29,59,C
2017,2166,Female,Perak,17,4,6,1,28,31,59,C
2018,2167,Male,Penang,21,8,8,2,39,23,62,B
2017,2168,Male,Terengganu,20,4,3,2,29,35,64,B
2017,2169,Male,Negeri Sembilan,17,9,7,5,38,36,74,B
2015,2170,Male,Sarawak,14,4,4,2,24,40,64,B
2015,2171,Female,Terengganu,19,3,10,5,37,30,67,B
2014,2172,Female,Malacca,14,9,3,5,31,22,53,C
2016,2173,Male,Penang,18,5,3,4,30,36,66,B
2016,2174,Male,Kelantan,18,7,9,4,38,33,71,B
2019,2175,Female,Penang,13,6,5,1,25,29,54,C
2014,2176,Male,Penang,18,7,9,5,39,24,63,B
2018,2177,Female,Perak,17,9,10,4,40,36,76,B
2019,2178,Male,Sarawak,18,6,9,3,36,31,67,B
2018,2179,Male,Kedah,20,6,5,3,34,22,56,C
2015,2180,Female,Johor,18,8,10,5,41,25,66,B
2016,2181,Female,Perlis,16,4,8,1,29,27,56,C
2018,2182,Female,Perlis,17,7,6,1,31,26,57,C
2019,2183,Female,Selangor,21,8,7,5,41,39,80,A
2014,2184,Female,Perlis,21,10,9,1,41,38,79,A
2019,2185,Male,Kelantan,18,6,8,3,35,36,71,B
2012,2186,Male,Penang,20,3,4,3,30,30,60,B
2016,2187,Male,Malacca,19,3,8,2,32,36,68,B
2015,2188,Male,Perak,19,6,7,5,37,32,69,B
2014,2189,Female,Johor,19,7,6,2,34,36,70,B
2017,2190,Male,Johor,19,10,5,5,39,29,68,B
2014,2191,Male,Perlis,16,9,3,4,32,25,57,C
2019,2192,Male,Kedah,19,4,3,1,27,25,52,C
2019,2193,Male,Kelantan,21,8,9,5,43,31,74,B
2019,2194,Female,Kelantan,18,4,4,3,29,32,61,B
2015,2195,Female,Kedah,15,10,9,3,37,26,63,B
2015,2196,Female,Kedah,13,4,5,4,26,26,52,C
2019,2197,Female,Johor,18,9,8,3,38,36,74,B
2012,2198,Female,Terengganu,18,4,4,1,27,36,63,B
2017,2199,Male,Johor,20,10,8,4,42,38,80,A
2016,2200,Male,Selangor,14,3,6,4,27,40,67,B
2014,2201,Female,Kedah,19,8,7,1,35,28,63,B
2014,2202,Female,Sabah,15,3,4,3,25,25,50,C
2016,2203,Male,Malacca,17,4,5,4,30,29,59,C
2014,2204,Male,Kelantan,18,10,5,2,35,28,63,B
2018,2205,Female,Sabah,20,6,5,2,33,35,68,B
2013,2206,Female,Perak,20,4,8,3,35,34,69,B
2012,2207,Female,Pahang,21,8,6,1,36,25,61,B
2012,2208,Male,Kedah,19,4,9,3,35,38,73,B
2019,2209,Female,Sabah,13,5,8,4,30,40,70,B
2019,2210,Male,Pahang,13,7,7,1,28,37,65,B
2019,2211,Male,Terengganu,14,3,4,5,26,28,54,C
2012,2212,Female,Malacca,15,6,4,4,29,23,52,C
2013,2213,Female,Perak,21,6,4,3,34,29,63,B
2015,2214,Female,Perlis,19,5,10,3,37,25,62,B
2017,2215,Female,Malacca,14,9,4,3,30,34,64,B
2015,2216,Male,Kelantan,16,6,8,5,35,33,68,B
2013,2217,Male,Malacca,17,3,9,3,32,26,58,C
2017,2218,Male,Negeri Sembilan,15,6,5,4,30,32,62,B
2019,2219,Male,Terengganu,13,4,7,4,28,28,56,C
2012,2220,Female,Perlis,14,7,5,2,28,37,65,B
2019,2221,Male,Terengganu,16,3,10,4,33,26,59,C
2014,2222,Female,Malacca,21,4,6,4,35,34,69,B
2015,2223,Male,Negeri Sembilan,21,8,3,3,35,22,57,C
2013,2224,Male,Perlis,20,4,5,5,34,23,57,C
2018,2225,Male,Johor,19,6,8,5,38,26,64,B
2014,2226,Male,Perak,20,5,5,5,35,34,69,B
2014,2227,Female,Malacca,20,10,7,4,41,26,67,B
2013,2228,Female,Kedah,14,10,9,5,38,30,68,B
2015,2229,Female,Terengganu,19,7,7,5,38,25,63,B
2017,2230,Female,Sarawak,17,3,6,2,28,24,52,C
2013,2231,Female,Pahang,21,3,3,3,30,25,55,C
2019,2232,Female,Perlis,13,9,5,4,31,31,62,B
2013,2233,Female,Penang,19,4,7,4,34,35,69,B
2017,2234,Male,Selangor,15,6,8,5,34,26,60,B
2018,2235,Female,Perlis,16,6,10,5,37,33,70,B
2017,2236,Female,Perak,21,9,6,1,37,34,71,B
2012,2237,Male,Perak,14,8,4,1,27,24,51,C
2015,2238,Male,Terengganu,14,10,4,2,30,35,65,B
2018,2239,Female,Negeri Sembilan,13,7,5,5,30,23,53,C
2015,2240,Male,Pahang,16,5,4,2,27,39,66,B
2014,2241,Female,Perlis,17,10,8,4,39,40,79,A
2012,2242,Female,Malacca,18,8,8,3,37,32,69,B
2013,2243,Male,Kedah,15,9,4,4,32,23,55,C
2019,2244,Male,Negeri Sembilan,13,3,7,5,28,27,55,C
2016,2245,Male,Sarawak,14,6,10,3,33,22,55,C
2018,2246,Male,Penang,14,7,6,1,28,40,68,B
2012,2247,Female,Sabah,15,8,5,2,30,25,55,C
2012,2248,Male,Perak,21,3,3,1,28,27,55,C
2015,2249,Female,Selangor,21,9,10,3,43,40,83,A
2017,2250,Female,Malacca,16,4,8,1,29,34,63,B
2015,2251,Male,Terengganu,17,9,7,1,34,28,62,B
2013,2252,Male,Penang,15,5,8,1,29,22,51,C
2015,2253,Female,Kedah,19,6,10,2,37,23,60,B
2017,2254,Female,Negeri Sembilan,17,9,8,2,36,40,76,B
2015,2255,Female,Penang,20,3,6,3,32,22,54,C
2019,2256,Male,Terengganu,14,3,4,1,22,40,62,B
2013,2257,Male,Sarawak,15,9,10,2,36,40,76,B
2019,2258,Female,Terengganu,17,4,5,1,27,29,56,C
2015,2259,Male,Negeri Sembilan,15,10,7,1,33,28,61,B
2018,2260,Female,Kelantan,16,8,6,4,34,27,61,B
2013,2261,Male,Selangor,16,10,4,3,33,25,58,C
2016,2262,Male,Negeri Sembilan,15,8,10,5,38,22,60,B
2015,2263,Female,Pahang,14,3,10,2,29,39,68,B
2013,2264,Male,Malacca,13,7,8,3,31,36,67,B
2012,2265,Female,Sarawak,16,9,9,4,38,24,62,B
2018,2266,Male,Pahang,17,8,10,3,38,22,60,B
2015,2267,Female,Malacca,19,3,7,3,32,27,59,C
2015,2268,Female,Perak,19,4,3,4,30,40,70,B
2013,2269,Female,Sarawak,20,3,8,1,32,23,55,C
2012,2270,Male,Penang,21,5,7,4,37,26,63,B
2017,2271,Female,Sabah,14,9,4,2,29,39,68,B
2016,2272,Female,Kelantan,18,10,8,4,40,24,64,B
2012,2273,Female,Sarawak,15,7,5,4,31,28,59,C
2018,2274,Male,Perlis,14,8,7,3,32,30,62,B
2014,2275,Female,Negeri Sembilan,20,8,10,2,40,32,72,B
2016,2276,Female,Selangor,13,4,5,4,26,25,51,C
2016,2277,Female,Negeri Sembilan,19,10,6,3,38,28,66,B
2013,2278,Female,Kelantan,19,8,6,5,38,35,73,B
2019,2279,Female,Sarawak,16,9,5,4,34,36,70,B
2013,2280,Male,Johor,15,8,6,3,32,38,70,B
2015,2281,Female,Kedah,17,5,8,4,34,37,71,B
2013,2282,Female,Sarawak,21,8,5,3,37,27,64,B
2017,2283,Male,Sarawak,15,5,4,1,25,30,55,C
2016,2284,Male,Kedah,13,6,4,1,24,22,46,F
2017,2285,Female,Selangor,18,3,7,2,30,32,62,B
2019,2286,Female,Pahang,20,5,4,3,32,29,61,B
2019,2287,Female,Perak,20,8,7,2,37,24,61,B
2018,2288,Male,Perak,17,9,4,5,35,35,70,B
2012,2289,Male,Sabah,19,7,10,5,41,29,70,B
2013,2290,Male,Negeri Sembilan,14,8,6,3,31,40,71,B
2014,2291,Male,Terengganu,15,6,3,1,25,36,61,B
2012,2292,Male,Terengganu,13,8,7,4,32,31,63,B
2019,2293,Female,Terengganu,18,3,9,4,34,40,74,B
2016,2294,Male,Perak,13,4,10,4,31,24,55,C
2018,2295,Female,Penang,21,6,5,4,36,40,76,B
2017,2296,Female,Kelantan,20,10,3,3,36,35,71,B
2014,2297,Female,Johor,16,9,6,3,34,32,66,B
2016,2298,Male,Johor,14,6,6,4,30,40,70,B
2014,2299,Female,Perak,13,7,10,1,31,37,68,B
2018,2300,Female,Penang,21,3,7,3,34,40,74,B
2016,2301,Male,Johor,13,10,8,1,32,38,70,B
2014,2302,Male,Selangor,18,6,10,2,36,23,59,C
2016,2303,Male,Perlis,13,7,4,1,25,35,60,B
2013,2304,Female,Sabah,18,3,6,5,32,23,55,C
2012,2305,Female,Penang,19,5,5,4,33,29,62,B
2012,2306,Male,Malacca,15,9,5,3,32,24,56,C
2016,2307,Male,Kedah,15,10,4,2,31,38,69,B
2019,2308,Female,Johor,19,5,5,1,30,25,55,C
2013,2309,Male,Kedah,13,7,8,2,30,30,60,B
2017,2310,Male,Malacca,21,3,7,4,35,38,73,B
2017,2311,Male,Terengganu,17,8,4,4,33,36,69,B
2018,2312,Male,Sarawak,17,7,8,2,34,24,58,C
2019,2313,Male,Sabah,16,8,9,4,37,33,70,B
2014,2314,Female,Perlis,18,8,10,4,40,27,67,B
2018,2315,Male,Penang,17,10,6,3,36,31,67,B
2015,2316,Female,Kelantan,16,5,7,3,31,31,62,B
2015,2317,Male,Perlis,21,8,9,1,39,27,66,B
2013,2318,Male,Terengganu,20,3,4,1,28,39,67,B
2017,2319,Male,Malacca,20,6,4,4,34,25,59,C
2014,2320,Female,Negeri Sembilan,20,10,6,2,38,37,75,B
2019,2321,Female,Terengganu,17,4,9,5,35,32,67,B
2016,2322,Female,Sabah,15,9,8,2,34,38,72,B
2017,2323,Female,Perlis,17,7,9,4,37,22,59,C
2014,2324,Female,Sabah,19,3,10,5,37,22,59,C
2017,2325,Male,Negeri Sembilan,16,5,9,1,31,29,60,B
2013,2326,Female,Penang,17,4,10,5,36,26,62,B
2015,2327,Female,Terengganu,18,5,10,4,37,35,72,B
2017,2328,Male,Selangor,21,5,9,2,37,22,59,C
2015,2329,Male,Penang,21,6,10,3,40,23,63,B
2014,2330,Male,Sabah,20,5,5,2,32,33,65,B
2013,2331,Male,Terengganu,21,3,3,2,29,33,62,B
2018,2332,Female,Pahang,13,6,8,1,28,30,58,C
2015,2333,Female,Terengganu,19,3,10,1,33,32,65,B
2019,2334,Male,Sarawak,20,10,8,3,41,29,70,B
2013,2335,Female,Negeri Sembilan,18,7,9,4,38,22,60,B
2017,2336,Male,Penang,19,6,10,3,38,35,73,B
2015,2337,Male,Malacca,13,3,7,5,28,22,50,C
2014,2338,Female,Kedah,18,7,10,4,39,22,61,B
2012,2339,Female,Selangor,15,8,5,1,29,39,68,B
2019,2340,Male,Johor,21,5,4,3,33,38,71,B
2019,2341,Male,Penang,21,7,6,4,38,33,71,B
2013,2342,Male,Malacca,20,9,10,5,44,34,78,B
2012,2343,Female,Negeri Sembilan,20,4,9,3,36,22,58,C
2018,2344,Male,Kelantan,19,4,9,4,36,34,70,B
2018,2345,Male,Perlis,19,7,3,2,31,23,54,C
2015,2346,Male,Penang,17,3,7,5,32,29,61,B
2015,2347,Male,Kelantan,20,5,8,2,35,27,62,B
2018,2348,Female,Sabah,21,10,7,1,39,31,70,B
2012,2349,Male,Selangor,21,10,6,4,41,39,80,A
2015,2350,Female,Kedah,20,8,5,3,36,25,61,B
2014,2351,Female,Kedah,15,3,8,5,31,40,71,B
2015,2352,Female,Pahang,14,8,10,2,34,25,59,C
2015,2353,Female,Perlis,14,8,10,2,34,24,58,C
2015,2354,Male,Perlis,19,8,8,1,36,30,66,B
2016,2355,Female,Negeri Sembilan,16,5,9,1,31,25,56,C
2016,2356,Female,Sarawak,19,10,9,3,41,27,68,B
2017,2357,Female,Sarawak,21,8,5,5,39,28,67,B
2016,2358,Male,Negeri Sembilan,18,10,4,2,34,32,66,B
2018,2359,Female,Johor,20,9,5,2,36,38,74,B
2012,2360,Female,Terengganu,21,9,7,3,40,36,76,B
2014,2361,Female,Kelantan,16,9,10,4,39,24,63,B
2013,2362,Female,Perlis,19,8,8,3,38,36,74,B
2015,2363,Male,Johor,13,7,9,2,31,22,53,C
2017,2364,Female,Kelantan,14,8,4,2,28,37,65,B
2015,2365,Female,Perlis,16,5,4,1,26,40,66,B
2019,2366,Female,Sabah,17,5,3,3,28,35,63,B
2017,2367,Female,Selangor,16,5,7,3,31,25,56,C
2013,2368,Male,Sabah,15,5,9,1,30,35,65,B
2012,2369,Female,Kedah,13,7,8,5,33,32,65,B
2013,2370,Female,Malacca,17,10,8,2,37,29,66,B
2016,2371,Female,Pahang,18,6,6,5,35,39,74,B
2015,2372,Female,Sabah,20,5,6,3,34,31,65,B
2017,2373,Male,Kedah,15,10,8,4,37,29,66,B
2017,2374,Male,Malacca,16,10,9,2,37,23,60,B
2016,2375,Female,Pahang,14,5,10,2,31,40,71,B
2015,2376,Female,Perak,19,10,8,4,41,23,64,B
2012,2377,Female,Sabah,16,8,3,2,29,23,52,C
2016,2378,Male,Negeri Sembilan,13,7,10,2,32,34,66,B
2015,2379,Male,Sabah,21,9,7,1,38,22,60,B
2017,2380,Female,Kelantan,15,10,4,2,31,32,63,B
2014,2381,Female,Perak,17,7,8,5,37,32,69,B
2014,2382,Male,Selangor,18,6,10,4,38,33,71,B
2019,2383,Female,Perlis,18,10,3,3,34,30,64,B
2014,2384,Male,Perlis,18,7,3,4,32,27,59,C
2019,2385,Female,Selangor,14,10,9,5,38,22,60,B
2019,2386,Female,Penang,15,3,3,5,26,33,59,C
2016,2387,Female,Negeri Sembilan,13,5,6,5,29,26,55,C
2015,2388,Male,Sarawak,21,6,5,4,36,38,74,B
2015,2389,Female,Perak,16,5,8,2,31,25,56,C
2019,2390,Male,Penang,14,6,5,1,26,28,54,C
2016,2391,Female,Kelantan,14,9,10,5,38,31,69,B
2017,2392,Male,Sarawak,15,5,5,1,26,27,53,C
2015,2393,Male,Malacca,18,9,3,2,32,31,63,B
2016,2394,Female,Perak,19,10,9,1,39,33,72,B
2013,2395,Male,Terengganu,15,6,9,1,31,32,63,B
2014,2396,Female,Malacca,15,8,3,3,29,22,51,C
2012,2397,Male,Penang,13,5,9,5,32,31,63,B
2017,2398,Male,Perak,21,5,6,5,37,22,59,C
2016,2399,Female,Perlis,15,8,10,5,38,32,70,B
2017,2400,Female,Johor,15,10,5,5,35,40,75,B
2015,2401,Female,Malacca,16,8,3,3,30,22,52,C
2016,2402,Female,Pahang,19,3,3,2,27,26,53,C
2013,2403,Male,Malacca,14,7,8,3,32,24,56,C
2016,2404,Male,Selangor,17,5,10,5,37,30,67,B
2017,2405,Female,Terengganu,15,10,10,2,37,27,64,B
2018,2406,Male,Terengganu,16,7,3,1,27,34,61,B
2017,2407,Male,Johor,19,4,6,2,31,25,56,C
2013,2408,Male,Sarawak,15,3,5,3,26,30,56,C
2015,2409,Female,Selangor,15,8,8,3,34,38,72,B
2018,2410,Female,Perak,20,3,10,1,34,28,62,B
2016,2411,Male,Malacca,20,6,8,2,36,36,72,B
2018,2412,Female,Sarawak,21,4,5,1,31,33,64,B
2012,2413,Male,Sarawak,16,9,7,4,36,25,61,B
2017,2414,Male,Perak,19,10,5,1,35,34,69,B
2013,2415,Female,Negeri Sembilan,14,6,5,4,29,35,64,B
2012,2416,Male,Perlis,21,6,3,2,32,25,57,C
2018,2417,Male,Pahang,16,9,3,5,33,32,65,B
2017,2418,Female,Penang,13,9,3,3,28,39,67,B
2012,2419,Female,Kelantan,13,7,6,5,31,23,54,C
2019,2420,Male,Malacca,15,4,5,3,27,33,60,B
2015,2421,Female,Sarawak,17,10,10,4,41,28,69,B
2014,2422,Female,Penang,21,9,3,4,37,36,73,B
2012,2423,Female,Terengganu,16,8,9,5,38,28,66,B
2018,2424,Male,Kedah,17,3,10,4,34,38,72,B
2017,2425,Female,Malacca,21,5,10,5,41,35,76,B
2012,2426,Male,Terengganu,21,10,10,4,45,22,67,B
2012,2427,Male,Kedah,17,7,5,1,30,29,59,C
2018,2428,Female,Kedah,17,10,3,3,33,34,67,B
2018,2429,Male,Negeri Sembilan,19,4,7,2,32,31,63,B
2015,2430,Female,Sarawak,20,10,10,5,45,35,80,A
2018,2431,Male,Terengganu,21,5,4,1,31,28,59,C
2014,2432,Female,Kedah,20,8,8,4,40,24,64,B
2012,2433,Male,Malacca,18,6,3,4,31,35,66,B
2016,2434,Female,Sarawak,21,8,5,1,35,31,66,B
2015,2435,Female,Negeri Sembilan,15,7,6,4,32,27,59,C
2017,2436,Male,Kedah,15,8,7,5,35,30,65,B
2018,2437,Female,Penang,20,7,3,1,31,39,70,B
2014,2438,Male,Malacca,18,8,9,3,38,35,73,B
2012,2439,Male,Kedah,13,4,6,5,28,25,53,C
2014,2440,Male,Perlis,14,4,4,3,25,30,55,C
2017,2441,Female,Kelantan,21,5,7,1,34,38,72,B
2015,2442,Male,Malacca,20,4,6,2,32,31,63,B
2012,2443,Female,Johor,20,3,10,1,34,25,59,C
2019,2444,Male,Selangor,15,6,3,3,27,23,50,C
2015,2445,Female,Perlis,14,7,3,3,27,25,52,C
2018,2446,Female,Malacca,19,9,8,5,41,33,74,B
2015,2447,Female,Perlis,19,10,8,2,39,24,63,B
2017,2448,Female,Negeri Sembilan,16,10,9,2,37,27,64,B
2012,2449,Female,Selangor,18,7,5,3,33,27,60,B
2014,2450,Male,Terengganu,19,5,10,3,37,33,70,B
2019,2451,Male,Terengganu,13,4,3,2,22,29,51,C
2017,2452,Female,Perak,16,3,5,4,28,32,60,B
2014,2453,Male,Johor,17,7,9,4,37,26,63,B
2012,2454,Female,Kelantan,15,3,10,1,29,40,69,B
2015,2455,Female,Terengganu,14,7,5,3,29,38,67,B
2019,2456,Female,Terengganu,16,8,4,4,32,34,66,B
2016,2457,Male,Penang,13,8,8,4,33,27,60,B
2013,2458,Female,Sarawak,20,10,6,4,40,27,67,B
2013,2459,Female,Johor,19,5,8,1,33,38,71,B
2016,2460,Female,Kelantan,17,8,7,3,35,25,60,B
2019,2461,Female,Negeri Sembilan,18,5,9,5,37,23,60,B
2015,2462,Male,Perak,15,9,6,1,31,30,61,B
2012,2463,Female,Kedah,17,4,6,1,28,33,61,B
2013,2464,Female,Kelantan,13,5,9,3,30,29,59,C
2016,2465,Female,Penang,21,8,5,3,37,39,76,B
2017,2466,Female,Terengganu,13,3,3,5,24,22,46,F
2017,2467,Female,Penang,17,5,8,4,34,40,74,B
2017,2468,Male,Kelantan,18,10,4,3,35,34,69,B
2012,2469,Female,Terengganu,16,4,8,1,29,32,61,B
2015,2470,Female,Selangor,20,7,8,2,37,36,73,B
2017,2471,Female,Johor,14,5,5,3,27,29,56,C
2013,2472,Female,Perak,19,5,8,2,34,36,70,B
2015,2473,Female,Terengganu,15,7,6,5,33,31,64,B
2014,2474,Male,Kelantan,18,7,3,1,29,36,65,B
2013,2475,Female,Penang,20,3,6,2,31,22,53,C
2012,2476,Female,Perak,16,9,3,1,29,40,69,B
2013,2477,Male,Terengganu,13,7,7,5,32,37,69,B
2014,2478,Female,Malacca,20,7,5,3,35,23,58,C
2012,2479,Female,Sarawak,21,4,10,1,36,22,58,C
2012,2480,Female,Johor,14,3,6,1,24,27,51,C
2019,2481,Male,Sabah,14,3,5,2,24,22,46,F
2016,2482,Male,Terengganu,17,5,3,4,29,22,51,C
2015,2483,Female,Terengganu,18,3,8,5,34,35,69,B
2013,2484,Male,Perak,21,9,3,5,38,28,66,B
2018,2485,Female,Pahang,15,7,4,2,28,30,58,C
2015,2486,Male,Selangor,19,10,4,5,38,32,70,B
2016,2487,Female,Selangor,13,4,9,3,29,29,58,C
2012,2488,Male,Kedah,13,9,9,5,36,33,69,B
2017,2489,Female,Kelantan,18,6,5,1,30,36,66,B
2013,2490,Female,Kedah,18,3,4,2,27,29,56,C
2012,2491,Male,Kedah,13,10,8,5,36,31,67,B
2015,2492,Female,Perak,15,6,10,4,35,24,59,C
2018,2493,Female,Perak,14,7,9,5,35,36,71,B
2015,2494,Male,Perlis,16,8,4,3,31,23,54,C
2012,2495,Male,Kelantan,21,7,3,4,35,27,62,B
2018,2496,Female,Kedah,15,8,3,1,27,23,50,C
2012,2497,Male,Terengganu,17,5,5,3,30,38,68,B
2018,2498,Male,Selangor,21,8,4,2,35,34,69,B
2017,2499,Female,Negeri Sembilan,15,4,8,4,31,28,59,C
2019,2500,Male,Pahang,18,10,7,3,38,24,62,B
2017,2501,Female,Johor,19,9,10,5,43,24,67,B
2019,2502,Female,Negeri Sembilan,18,4,10,5,37,33,70,B
2013,2503,Female,Selangor,19,5,10,5,39,40,79,A
2017,2504,Female,Kedah,16,4,6,3,29,40,69,B
2013,2505,Female,Johor,20,3,8,2,33,22,55,C
2013,2506,Male,Johor,13,6,4,2,25,22,47,F
2013,2507,Female,Sabah,13,6,4,3,26,23,49,F
2018,2508,Female,Penang,19,4,6,2,31,27,58,C
2016,2509,Female,Kedah,20,7,8,2,37,39,76,B
2012,2510,Female,Perlis,17,9,10,2,38,35,73,B
2015,2511,Female,Pahang,18,4,8,1,31,32,63,B
2012,2512,Female,Kelantan,19,5,5,3,32,39,71,B
2012,2513,Male,Sarawak,20,8,6,1,35,22,57,C
2013,2514,Male,Pahang,19,10,9,5,43,27,70,B
2018,2515,Female,Terengganu,18,7,4,4,33,32,65,B
2015,2516,Female,Terengganu,14,7,5,3,29,34,63,B
2014,2517,Male,Malacca,18,8,10,1,37,29,66,B
2015,2518,Female,Negeri Sembilan,18,10,6,1,35,33,68,B
2014,2519,Female,Pahang,13,7,7,1,28,37,65,B
2016,2520,Male,Perak,17,7,3,5,32,22,54,C
2019,2521,Female,Johor,15,8,5,5,33,37,70,B
2016,2522,Female,Perak,17,5,7,1,30,37,67,B
2018,2523,Female,Negeri Sembilan,13,5,9,4,31,28,59,C
2016,2524,Female,Johor,21,3,4,3,31,27,58,C
2017,2525,Female,Malacca,21,10,6,3,40,33,73,B
2018,2526,Male,Kelantan,15,5,7,3,30,38,68,B
2013,2527,Male,Selangor,16,8,5,1,30,34,64,B
2014,2528,Female,Selangor,16,3,6,2,27,36,63,B
2012,2529,Female,Sarawak,18,5,10,1,34,24,58,C
2017,2530,Male,Sarawak,21,10,3,1,35,22,57,C
2018,2531,Female,Terengganu,18,4,9,1,32,36,68,B
2013,2532,Male,Malacca,21,9,3,4,37,31,68,B
2019,2533,Male,Perak,20,10,6,4,40,29,69,B
2014,2534,Male,Johor,15,7,10,5,37,31,68,B
2016,2535,Female,Malacca,13,10,8,1,32,40,72,B
2012,2536,Male,Sabah,16,8,5,1,30,37,67,B
2017,2537,Female,Perlis,21,4,9,5,39,35,74,B
2016,2538,Female,Johor,19,4,8,4,35,28,63,B
2013,2539,Female,Malacca,13,5,10,4,32,38,70,B
2019,2540,Male,Malacca,14,3,10,1,28,38,66,B
2012,2541,Female,Sarawak,18,5,5,3,31,25,56,C
2015,2542,Male,Sarawak,21,10,10,3,44,22,66,B
2014,2543,Female,Negeri Sembilan,17,7,5,3,32,27,59,C
2018,2544,Female,Negeri Sembilan,20,5,6,3,34,23,57,C
2018,2545,Male,Malacca,14,7,9,5,35,25,60,B
2014,2546,Male,Penang,15,6,10,3,34,34,68,B
2017,2547,Female,Sabah,15,9,6,4,34,26,60,B
2015,2548,Female,Perlis,17,6,10,1,34,23,57,C
2012,2549,Male,Malacca,21,9,6,4,40,39,79,A
2018,2550,Female,Kelantan,21,7,6,4,38,31,69,B
2019,2551,Female,Kelantan,21,8,8,1,38,27,65,B
2013,2552,Male,Terengganu,15,7,4,4,30,38,68,B
2012,2553,Female,Kelantan,13,8,10,5,36,22,58,C
2016,2554,Female,Selangor,16,4,8,1,29,30,59,C
2015,2555,Male,Perlis,18,9,4,5,36,33,69,B
2018,2556,Female,Malacca,14,4,4,3,25,40,65,B
2014,2557,Male,Penang,21,4,4,2,31,34,65,B
2018,2558,Male,Perlis,17,5,10,4,36,28,64,B
2014,2559,Male,Selangor,16,5,7,4,32,25,57,C
2012,2560,Male,Selangor,18,4,9,5,36,33,69,B
2017,2561,Male,Pahang,13,5,7,4,29,22,51,C
2016,2562,Male,Pahang,15,10,7,1,33,24,57,C
2014,2563,Male,Penang,16,6,10,2,34,37,71,B
2015,2564,Female,Kedah,13,8,10,3,34,24,58,C
2014,2565,Male,Perlis,18,4,8,2,32,34,66,B
2015,2566,Male,Kelantan,17,6,6,2,31,32,63,B
2015,2567,Female,Perlis,18,10,9,3,40,39,79,A
2012,2568,Male,Kelantan,14,4,6,4,28,38,66,B
2016,2569,Female,Selangor,20,9,6,2,37,25,62,B
2018,2570,Male,Johor,21,6,9,3,39,28,67,B
2015,2571,Male,Sabah,14,5,6,3,28,40,68,B
2019,2572,Female,Sarawak,21,4,7,5,37,36,73,B
2012,2573,Female,Malacca,17,6,7,4,34,39,73,B
2013,2574,Female,Sabah,17,5,6,5,33,23,56,C
2013,2575,Male,Terengganu,20,5,4,5,34,37,71,B
2016,2576,Female,Sarawak,21,8,9,3,41,32,73,B
2014,2577,Female,Malacca,19,8,9,5,41,29,70,B
2017,2578,Male,Sarawak,20,3,5,4,32,37,69,B
2018,2579,Male,Perlis,16,5,3,2,26,27,53,C
2016,2580,Male,Negeri Sembilan,15,8,4,1,28,31,59,C
2016,2581,Female,Perlis,17,7,4,1,29,35,64,B
2014,2582,Male,Terengganu,15,5,7,1,28,32,60,B
2019,2583,Female,Terengganu,17,8,9,3,37,31,68,B
2012,2584,Male,Sabah,21,4,4,1,30,27,57,C
2014,2585,Male,Selangor,21,5,6,1,33,27,60,B
2018,2586,Female,Perlis,14,6,10,4,34,31,65,B
2017,2587,Male,Pahang,20,10,5,5,40,36,76,B
2018,2588,Female,Terengganu,15,4,7,3,29,29,58,C
2013,2589,Female,Kedah,14,6,5,3,28,29,57,C
2013,2590,Female,Kedah,21,4,6,4,35,35,70,B
2015,2591,Female,Sarawak,13,8,9,5,35,31,66,B
2013,2592,Male,Penang,14,6,7,3,30,33,63,B
2016,2593,Female,Perlis,21,8,3,1,33,35,68,B
2012,2594,Male,Sarawak,17,4,4,3,28,23,51,C
2013,2595,Female,Sabah,18,8,5,2,33,35,68,B
2014,2596,Female,Kelantan,18,5,7,5,35,29,64,B
2017,2597,Female,Perak,17,6,9,2,34,26,60,B
2017,2598,Female,Penang,21,3,6,4,34,28,62,B
2017,2599,Female,Selangor,17,8,3,4,32,29,61,B
2012,2600,Female,Perlis,16,6,6,1,29,34,63,B
2015,2601,Female,Terengganu,16,9,8,2,35,40,75,B
2015,2602,Male,Malacca,21,8,5,2,36,33,69,B
2014,2603,Male,Sarawak,13,5,10,3,31,38,69,B
2019,2604,Female,Penang,14,5,9,5,33,40,73,B
2016,2605,Female,Negeri Sembilan,19,5,4,1,29,22,51,C
2015,2606,Female,Johor,18,8,9,1,36,28,64,B
2012,2607,Male,Kedah,15,3,9,3,30,23,53,C
2018,2608,Male,Johor,16,10,6,4,36,34,70,B
2012,2609,Male,Johor,21,7,10,2,40,35,75,B
2014,2610,Male,Kedah,21,7,5,2,35,25,60,B
2015,2611,Male,Malacca,16,3,4,4,27,37,64,B
2018,2612,Male,Malacca,14,9,7,2,32,39,71,B
2015,2613,Female,Malacca,14,9,7,3,33,24,57,C
2017,2614,Female,Kelantan,16,4,5,3,28,22,50,C
2018,2615,Female,Malacca,16,7,10,3,36,34,70,B
2012,2616,Male,Penang,20,3,9,2,34,40,74,B
2012,2617,Male,Sabah,13,9,10,4,36,39,75,B
2016,2618,Female,Pahang,14,5,7,3,29,30,59,C
2018,2619,Female,Selangor,17,8,8,4,37,29,66,B
2012,2620,Female,Pahang,14,3,3,5,25,27,52,C
2012,2621,Male,Selangor,16,9,5,4,34,29,63,B
2016,2622,Male,Perak,19,7,6,5,37,36,73,B
2017,2623,Male,Pahang,20,9,7,1,37,34,71,B
2017,2624,Female,Negeri Sembilan,16,6,10,1,33,38,71,B
2016,2625,Male,Johor,14,8,6,1,29,22,51,C
2013,2626,Male,Negeri Sembilan,21,5,7,3,36,38,74,B
2019,2627,Female,Johor,20,7,3,1,31,34,65,B
2018,2628,Male,Selangor,17,9,10,1,37,32,69,B
2012,2629,Male,Malacca,16,6,7,2,31,25,56,C
2016,2630,Female,Selangor,16,6,9,1,32,38,70,B
2018,2631,Male,Perak,19,8,5,3,35,39,74,B
2019,2632,Female,Malacca,17,4,10,2,33,28,61,B
2013,2633,Male,Perlis,13,7,7,4,31,25,56,C
2014,2634,Female,Negeri Sembilan,15,4,6,3,28,25,53,C
2013,2635,Female,Kelantan,20,8,5,4,37,39,76,B
2019,2636,Female,Negeri Sembilan,18,4,5,5,32,38,70,B
2012,2637,Male,Pahang,18,8,5,3,34,27,61,B
2019,2638,Male,Sabah,13,4,5,4,26,27,53,C
2016,2639,Female,Kelantan,21,7,9,4,41,39,80,A
2012,2640,Male,Johor,21,10,10,1,42,34,76,B
2013,2641,Female,Selangor,19,6,5,4,34,24,58,C
2013,2642,Male,Penang,21,9,5,2,37,40,77,B
2012,2643,Female,Johor,17,3,6,3,29,25,54,C
2014,2644,Female,Kelantan,20,9,6,1,36,26,62,B
2013,2645,Male,Pahang,13,3,5,3,24,39,63,B
2014,2646,Male,Sarawak,13,4,4,2,23,28,51,C
2019,2647,Male,Perlis,14,6,4,1,25,30,55,C
2015,2648,Male,Johor,18,3,6,1,28,38,66,B
2017,2649,Female,Selangor,16,9,10,1,36,36,72,B
2012,2650,Male,Sabah,21,10,9,3,43,35,78,B
2015,2651,Female,Negeri Sembilan,18,5,6,4,33,38,71,B
2012,2652,Female,Terengganu,18,9,6,5,38,30,68,B
2019,2653,Male,Perak,13,8,7,4,32,39,71,B
2013,2654,Male,Malacca,17,7,7,2,33,31,64,B
2017,2655,Female,Sarawak,20,9,10,4,43,23,66,B
2016,2656,Male,Malacca,20,8,4,3,35,27,62,B
2016,2657,Female,Perlis,14,6,8,2,30,22,52,C
2019,2658,Male,Terengganu,14,6,7,2,29,22,51,C
2019,2659,Male,Negeri Sembilan,19,9,10,5,43,34,77,B
2017,2660,Female,Sabah,17,4,3,5,29,39,68,B
2017,2661,Female,Sabah,21,9,6,4,40,36,76,B
2017,2662,Male,Kelantan,19,9,9,4,41,24,65,B
2018,2663,Male,Kelantan,15,5,10,4,34,23,57,C
2015,2664,Male,Negeri Sembilan,14,9,3,3,29,35,64,B
2017,2665,Male,Pahang,20,4,9,1,34,24,58,C
2018,2666,Female,Penang,20,5,4,2,31,36,67,B
2017,2667,Female,Pahang,16,4,6,4,30,22,52,C
2014,2668,Male,Kelantan,19,3,6,3,31,32,63,B
2016,2669,Male,Perlis,14,5,4,3,26,40,66,B
2013,2670,Female,Kedah,14,9,4,4,31,31,62,B
2019,2671,Female,Perlis,15,5,7,2,29,34,63,B
2014,2672,Female,Penang,19,7,5,3,34,32,66,B
2015,2673,Male,Selangor,19,3,10,5,37,36,73,B
2013,2674,Male,Negeri Sembilan,17,7,5,1,30,24,54,C
2019,2675,Female,Perak,21,3,8,2,34,36,70,B
2019,2676,Male,Kedah,14,7,5,2,28,35,63,B
2012,2677,Female,Sabah,21,4,4,4,33,31,64,B
2012,2678,Female,Sarawak,13,8,10,4,35,28,63,B
2015,2679,Female,Malacca,20,10,10,4,44,24,68,B
2015,2680,Female,Perlis,21,8,8,2,39,34,73,B
2012,2681,Male,Penang,17,8,9,4,38,31,69,B
2016,2682,Male,Selangor,20,8,3,3,34,31,65,B
2014,2683,Female,Johor,16,6,8,4,34,22,56,C
2018,2684,Male,Terengganu,13,10,6,4,33,33,66,B
2016,2685,Male,Malacca,13,10,3,5,31,38,69,B
2014,2686,Female,Perak,13,8,9,1,31,37,68,B
2019,2687,Female,Johor,15,6,10,5,36,32,68,B
2017,2688,Female,Kelantan,17,3,10,2,32,39,71,B
2015,2689,Male,Penang,16,5,9,4,34,27,61,B
2019,2690,Female,Perak,14,8,3,1,26,36,62,B
2015,2691,Male,Kedah,20,9,8,3,40,32,72,B
2015,2692,Female,Perak,14,3,7,1,25,22,47,F
2019,2693,Female,Negeri Sembilan,19,5,10,2,36,26,62,B
2018,2694,Female,Malacca,14,5,4,1,24,32,56,C
2016,2695,Male,Kelantan,20,6,6,4,36,35,71,B
2018,2696,Male,Penang,17,5,4,4,30,22,52,C
2014,2697,Male,Sabah,14,6,3,4,27,36,63,B
2014,2698,Female,Pahang,19,9,10,3,41,26,67,B
2013,2699,Male,Sarawak,14,4,4,2,24,35,59,C
2015,2700,Female,Kelantan,16,8,10,5,39,23,62,B
2015,2701,Female,Selangor,19,9,7,5,40,25,65,B
2018,2702,Female,Penang,15,7,10,2,34,28,62,B
2013,2703,Male,Pahang,20,10,8,2,40,39,79,A
2013,2704,Male,Perlis,13,7,4,5,29,38,67,B
2016,2705,Male,Penang,16,3,3,5,27,26,53,C
2014,2706,Female,Pahang,15,9,5,3,32,35,67,B
2019,2707,Female,Kedah,17,9,5,2,33,36,69,B
2019,2708,Female,Kelantan,18,5,10,2,35,32,67,B
2018,2709,Male,Kelantan,21,7,10,3,41,25,66,B
2019,2710,Male,Pahang,13,6,3,3,25,28,53,C
2018,2711,Male,Kelantan,18,10,10,1,39,27,66,B
2019,2712,Male,Negeri Sembilan,18,6,8,4,36,38,74,B
2016,2713,Female,Negeri Sembilan,16,8,9,2,35,30,65,B
2016,2714,Male,Sarawak,17,9,3,3,32,27,59,C
2019,2715,Female,Pahang,17,3,9,1,30,24,54,C
2019,2716,Male,Selangor,13,10,9,5,37,31,68,B
2018,2717,Female,Terengganu,16,5,3,4,28,34,62,B
2015,2718,Male,Pahang,13,9,8,1,31,33,64,B
2016,2719,Male,Negeri Sembilan,19,3,4,3,29,29,58,C
2016,2720,Male,Johor,21,6,3,3,33,35,68,B
2018,2721,Male,Terengganu,19,5,4,3,31,30,61,B
2013,2722,Female,Perak,20,8,7,1,36,28,64,B
2015,2723,Female,Perlis,21,5,9,1,36,29,65,B
2016,2724,Female,Perak,14,8,7,1,30,31,61,B
2017,2725,Male,Malacca,17,7,4,2,30,27,57,C
2012,2726,Female,Malacca,21,4,6,3,34,26,60,B
2012,2727,Male,Pahang,15,6,10,4,35,32,67,B
2016,2728,Male,Sabah,15,5,6,1,27,32,59,C
2019,2729,Male,Selangor,14,3,5,4,26,34,60,B
2017,2730,Male,Penang,14,4,8,1,27,24,51,C
2014,2731,Female,Terengganu,20,8,3,4,35,23,58,C
2013,2732,Male,Malacca,18,3,9,3,33,28,61,B
2012,2733,Female,Pahang,19,8,5,1,33,35,68,B
2012,2734,Female,Kedah,18,9,5,1,33,30,63,B
2019,2735,Female,Terengganu,19,9,8,2,38,24,62,B
2016,2736,Male,Malacca,19,9,8,3,39,26,65,B
2017,2737,Female,Pahang,15,8,4,3,30,33,63,B
2015,2738,Male,Terengganu,21,9,5,5,40,25,65,B
2016,2739,Female,Selangor,13,5,10,1,29,22,51,C
2019,2740,Female,Perlis,17,7,10,3,37,27,64,B
2012,2741,Female,Negeri Sembilan,20,8,5,2,35,34,69,B
2017,2742,Male,Kedah,14,3,10,1,28,38,66,B
2014,2743,Male,Perlis,14,10,4,1,29,37,66,B
2013,2744,Female,Terengganu,18,9,5,1,33,31,64,B
2014,2745,Male,Sabah,15,10,7,2,34,24,58,C
2016,2746,Male,Johor,18,7,5,2,32,36,68,B
2013,2747,Male,Perlis,16,9,3,3,31,32,63,B
2014,2748,Male,Kelantan,15,7,8,2,32,24,56,C
2012,2749,Female,Kedah,13,7,7,2,29,22,51,C
2019,2750,Male,Perak,20,4,8,1,33,32,65,B
2017,2751,Female,Penang,15,10,3,4,32,26,58,C
2017,2752,Male,Kelantan,19,7,9,4,39,38,77,B
2015,2753,Female,Perak,14,3,9,3,29,23,52,C
2013,2754,Female,Pahang,21,7,6,4,38,26,64,B
2013,2755,Male,Penang,21,3,5,3,32,40,72,B
2018,2756,Female,Malacca,16,3,6,4,29,30,59,C
2012,2757,Female,Perak,14,3,8,1,26,38,64,B
2016,2758,Female,Kedah,19,8,10,2,39,33,72,B
2018,2759,Male,Terengganu,19,5,4,1,29,26,55,C
2013,2760,Male,Perak,17,7,9,3,36,29,65,B
2016,2761,Female,Selangor,18,4,9,4,35,22,57,C
2016,2762,Female,Malacca,17,8,9,2,36,36,72,B
2012,2763,Male,Selangor,15,5,10,1,31,36,67,B
2012,2764,Male,Perak,16,6,10,1,33,25,58,C
2013,2765,Female,Johor,21,3,6,3,33,22,55,C
2017,2766,Female,Kelantan,13,5,6,5,29,30,59,C
2013,2767,Female,Negeri Sembilan,15,10,8,4,37,22,59,C
2017,2768,Female,Johor,15,4,6,3,28,23,51,C
2015,2769,Female,Perak,17,8,10,4,39,29,68,B
2013,2770,Male,Kedah,19,6,3,4,32,29,61,B
2012,2771,Female,Terengganu,15,9,9,4,37,33,70,B
2013,2772,Female,Sabah,18,4,5,5,32,28,60,B
2014,2773,Female,Terengganu,16,4,7,1,28,33,61,B
2013,2774,Male,Penang,16,8,7,3,34,24,58,C
2018,2775,Male,Penang,13,8,10,1,32,29,61,B
2019,2776,Male,Sabah,13,4,10,4,31,27,58,C
2019,2777,Female,Johor,13,4,4,4,25,33,58,C
2019,2778,Male,Sarawak,13,8,10,1,32,24,56,C
2019,2779,Female,Sarawak,21,8,8,5,42,28,70,B
2019,2780,Male,Sabah,16,8,9,4,37,30,67,B
2015,2781,Male,Selangor,17,8,6,1,32,39,71,B
2014,2782,Male,Perlis,13,10,7,4,34,34,68,B
2014,2783,Female,Terengganu,14,6,8,2,30,34,64,B
2018,2784,Male,Sabah,19,3,3,1,26,29,55,C
2016,2785,Female,Terengganu,13,7,10,4,34,22,56,C
2015,2786,Female,Sabah,19,9,5,4,37,36,73,B
2019,2787,Female,Kelantan,21,7,10,1,39,38,77,B
2017,2788,Male,Sabah,16,3,5,5,29,33,62,B
2017,2789,Female,Malacca,18,3,8,2,31,38,69,B
2019,2790,Male,Perak,21,6,9,5,41,40,81,A
2015,2791,Female,Kedah,13,6,6,1,26,36,62,B
2016,2792,Female,Penang,20,6,7,1,34,31,65,B
2015,2793,Female,Malacca,21,4,8,3,36,36,72,B
2013,2794,Female,Kelantan,19,9,9,1,38,32,70,B
2014,2795,Male,Perlis,21,6,6,2,35,25,60,B
2012,2796,Female,Malacca,21,10,3,4,38,26,64,B
2015,2797,Female,Sarawak,17,8,8,4,37,40,77,B
2016,2798,Male,Malacca,20,7,4,5,36,36,72,B
2012,2799,Female,Perlis,19,10,7,3,39,33,72,B
2019,2800,Male,Kelantan,13,10,7,3,33,37,70,B
2013,2801,Male,Perlis,20,7,3,1,31,30,61,B
2014,2802,Male,Sabah,17,5,10,3,35,33,68,B
2019,2803,Female,Sarawak,17,7,5,2,31,32,63,B
2013,2804,Female,Penang,13,6,5,2,26,32,58,C
2015,2805,Female,Kedah,21,6,5,3,35,30,65,B
2017,2806,Male,Perlis,14,6,4,4,28,31,59,C
2016,2807,Male,Perlis,16,5,10,4,35,26,61,B
2019,2808,Male,Kelantan,19,7,7,4,37,40,77,B
2019,2809,Male,Selangor,21,8,8,4,41,31,72,B
2016,2810,Male,Malacca,20,9,5,3,37,30,67,B
2018,2811,Male,Johor,21,9,5,3,38,27,65,B
2019,2812,Female,Negeri Sembilan,13,9,7,5,34,24,58,C
2013,2813,Female,Selangor,20,9,10,5,44,39,83,A
2016,2814,Male,Negeri Sembilan,19,10,5,5,39,25,64,B
2013,2815,Male,Johor,13,6,6,2,27,26,53,C
2013,2816,Male,Terengganu,21,3,6,2,32,26,58,C
2016,2817,Male,Kelantan,19,10,8,3,40,39,79,A
2013,2818,Male,Penang,15,6,3,2,26,37,63,B
2016,2819,Male,Johor,19,8,3,4,34,35,69,B
2014,2820,Female,Johor,15,5,6,1,27,38,65,B
2015,2821,Female,Selangor,13,6,3,2,24,32,56,C
2012,2822,Female,Pahang,18,7,3,1,29,24,53,C
2013,2823,Female,Perak,20,9,3,5,37,36,73,B
2018,2824,Female,Negeri Sembilan,20,8,7,5,40,30,70,B
2018,2825,Female,Malacca,19,4,4,2,29,29,58,C
2017,2826,Male,Perlis,16,7,9,2,34,28,62,B
2014,2827,Male,Penang,19,7,4,3,33,26,59,C
2013,2828,Female,Kedah,15,5,10,2,32,33,65,B
2014,2829,Male,Perlis,13,6,6,4,29,35,64,B
2014,2830,Male,Perak,15,7,3,4,29,38,67,B
2018,2831,Male,Pahang,13,6,3,3,25,29,54,C
2015,2832,Male,Negeri Sembilan,14,10,6,4,34,26,60,B
2014,2833,Female,Negeri Sembilan,14,6,4,4,28,31,59,C
2012,2834,Female,Kelantan,16,8,9,1,34,28,62,B
2016,2835,Male,Selangor,17,5,9,2,33,30,63,B
2012,2836,Female,Penang,17,10,3,2,32,36,68,B
2012,2837,Male,Negeri Sembilan,18,8,10,3,39,40,79,A
2012,2838,Female,Penang,17,3,8,2,30,35,65,B
2019,2839,Male,Selangor,17,8,9,3,37,29,66,B
2012,2840,Male,Kelantan,20,9,10,2,41,25,66,B
2014,2841,Female,Pahang,18,7,3,3,31,28,59,C
2017,2842,Female,Sarawak,21,8,9,3,41,40,81,A
2019,2843,Male,Negeri Sembilan,13,10,4,4,31,40,71,B
2019,2844,Male,Perak,14,10,6,4,34,26,60,B
2019,2845,Male,Perlis,16,8,8,5,37,30,67,B
2015,2846,Female,Terengganu,14,7,7,3,31,34,65,B
2014,2847,Male,Terengganu,20,6,10,1,37,30,67,B
2019,2848,Male,Selangor,15,4,10,2,31,31,62,B
2018,2849,Male,Kelantan,16,4,7,4,31,24,55,C
2013,2850,Female,Kedah,13,5,10,1,29,35,64,B
2019,2851,Female,Selangor,20,7,5,3,35,27,62,B
2014,2852,Female,Kedah,14,8,7,3,32,26,58,C
2018,2853,Female,Sarawak,13,6,10,4,33,32,65,B
2016,2854,Female,Kedah,15,8,5,3,31,40,71,B
2013,2855,Female,Pahang,21,9,4,2,36,26,62,B
2012,2856,Male,Sabah,21,6,6,5,38,31,69,B
2017,2857,Female,Kedah,18,5,10,3,36,30,66,B
2019,2858,Female,Terengganu,14,6,8,1,29,22,51,C
2017,2859,Male,Kedah,21,6,4,1,32,36,68,B
2018,2860,Female,Penang,13,3,4,5,25,26,51,C
2016,2861,Male,Sarawak,19,5,4,1,29,22,51,C
2016,2862,Male,Negeri Sembilan,19,6,7,1,33,39,72,B
2016,2863,Female,Terengganu,16,10,10,3,39,37,76,B
2014,2864,Female,Selangor,19,9,10,4,42,27,69,B
2012,2865,Male,Perlis,16,7,10,2,35,22,57,C
2018,2866,Male,Malacca,18,5,6,1,30,26,56,C
2012,2867,Male,Selangor,14,3,10,1,28,26,54,C
2016,2868,Male,Malacca,20,8,8,2,38,26,64,B
2016,2869,Female,Johor,15,5,6,2,28,40,68,B
2016,2870,Female,Sabah,17,6,8,2,33,26,59,C
2016,2871,Male,Kedah,21,10,6,5,42,23,65,B
2018,2872,Female,Sarawak,19,10,7,3,39,32,71,B
2016,2873,Male,Kedah,20,7,3,5,35,29,64,B
2014,2874,Female,Perlis,17,8,4,2,31,32,63,B
2013,2875,Male,Negeri Sembilan,18,6,3,1,28,22,50,C
2016,2876,Male,Perlis,18,9,6,3,36,40,76,B
2015,2877,Male,Perlis,13,9,3,2,27,33,60,B
2013,2878,Female,Perak,17,7,8,5,37,33,70,B
2015,2879,Male,Negeri Sembilan,21,3,4,5,33,35,68,B
2019,2880,Female,Pahang,17,4,4,4,29,34,63,B
2016,2881,Male,Selangor,21,5,3,5,34,39,73,B
2017,2882,Male,Kelantan,14,8,6,3,31,25,56,C
2013,2883,Male,Perlis,15,10,3,2,30,36,66,B
2019,2884,Male,Negeri Sembilan,19,8,7,3,37,33,70,B
2017,2885,Female,Kedah,15,9,7,2,33,37,70,B
2019,2886,Female,Pahang,21,10,6,1,38,38,76,B
2012,2887,Male,Sabah,20,3,3,4,30,22,52,C
2017,2888,Female,Johor,19,3,5,2,29,26,55,C
2017,2889,Female,Terengganu,16,10,4,4,34,39,73,B
2013,2890,Female,Sarawak,18,3,5,3,29,37,66,B
2016,2891,Male,Sabah,17,10,3,5,35,25,60,B
2012,2892,Male,Kedah,15,8,3,1,27,37,64,B
2012,2893,Male,Sabah,16,6,10,4,36,32,68,B
2017,2894,Female,Malacca,15,5,8,3,31,30,61,B
2013,2895,Female,Sarawak,18,4,5,4,31,38,69,B
2019,2896,Female,Sarawak,17,8,10,2,37,25,62,B
2019,2897,Male,Sarawak,15,9,5,3,32,27,59,C
2018,2898,Male,Sarawak,13,4,9,3,29,24,53,C
2018,2899,Female,Terengganu,13,9,3,1,26,40,66,B
2013,2900,Male,Malacca,17,3,5,3,28,35,63,B
2019,2901,Male,Terengganu,15,8,8,1,32,39,71,B
2015,2902,Male,Kelantan,16,7,8,2,33,28,61,B
2012,2903,Female,Penang,18,6,7,4,35,38,73,B
2013,2904,Female,Terengganu,21,8,10,5,44,37,81,A
2013,2905,Male,Kelantan,19,6,7,3,35,35,70,B
2016,2906,Female,Sabah,16,8,8,2,34,32,66,B
2013,2907,Male,Kedah,16,5,3,1,25,24,49,F
2019,2908,Female,Kedah,19,9,7,3,38,31,69,B
2017,2909,Female,Malacca,17,3,8,1,29,34,63,B
2016,2910,Male,Penang,16,7,7,3,33,40,73,B
2019,2911,Male,Kelantan,18,7,10,1,36,35,71,B
2018,2912,Female,Terengganu,15,5,8,4,32,24,56,C
2015,2913,Female,Terengganu,18,6,5,5,34,26,60,B
2013,2914,Male,Sarawak,19,10,9,5,43,38,81,A
2012,2915,Female,Malacca,16,10,6,5,37,36,73,B
2018,2916,Male,Penang,14,4,8,1,27,28,55,C
2017,2917,Female,Kelantan,14,9,9,1,33,35,68,B
2015,2918,Female,Sarawak,13,8,9,5,35,25,60,B
2017,2919,Male,Terengganu,13,3,6,1,23,38,61,B
2018,2920,Female,Johor,14,3,7,1,25,32,57,C
2016,2921,Female,Sabah,20,7,9,2,38,27,65,B
2016,2922,Female,Pahang,20,8,5,5,38,35,73,B
2014,2923,Female,Penang,16,5,4,5,30,35,65,B
2016,2924,Female,Terengganu,14,4,7,2,27,23,50,C
2019,2925,Female,Terengganu,18,5,10,2,35,28,63,B
2017,2926,Female,Selangor,21,5,10,5,41,22,63,B
2017,2927,Male,Perak,14,9,4,3,30,22,52,C
2016,2928,Male,Johor,15,8,9,2,34,26,60,B
2013,2929,Male,Johor,15,10,10,1,36,31,67,B
2017,2930,Female,Kelantan,14,6,4,4,28,26,54,C
2016,2931,Female,Sarawak,19,7,5,2,33,30,63,B
2013,2932,Female,Malacca,15,9,5,4,33,25,58,C
2018,2933,Female,Sarawak,17,4,5,2,28,33,61,B
2018,2934,Male,Kelantan,21,4,9,1,35,26,61,B
2018,2935,Male,Perlis,14,9,6,2,31,27,58,C
2019,2936,Female,Perak,16,3,3,3,25,27,52,C
2019,2937,Female,Malacca,15,4,6,1,26,25,51,C
2016,2938,Female,Negeri Sembilan,18,9,8,3,38,40,78,B
2019,2939,Male,Kedah,21,8,10,3,42,29,71,B
2018,2940,Male,Perak,13,5,10,1,29,33,62,B
2013,2941,Male,Malacca,15,6,4,5,30,24,54,C
2018,2942,Female,Selangor,16,3,3,5,27,32,59,C
2019,2943,Male,Perak,15,8,4,1,28,39,67,B
2015,2944,Male,Sarawak,17,9,3,1,30,33,63,B
2018,2945,Female,Johor,18,6,5,2,31,38,69,B
2013,2946,Female,Perak,19,3,6,4,32,39,71,B
2018,2947,Female,Pahang,13,5,7,4,29,29,58,C
2017,2948,Female,Kelantan,14,4,9,5,32,29,61,B
2019,2949,Female,Kedah,13,6,9,3,31,29,60,B
2013,2950,Female,Kelantan,20,6,8,3,37,22,59,C
2014,2951,Female,Malacca,17,8,9,3,37,26,63,B
2016,2952,Female,Malacca,17,9,10,3,39,40,79,A
2013,2953,Female,Penang,15,9,8,2,34,39,73,B
2018,2954,Male,Sabah,20,5,8,5,38,37,75,B
2019,2955,Male,Negeri Sembilan,19,4,6,1,30,33,63,B
2015,2956,Male,Sarawak,20,7,10,3,40,30,70,B
2018,2957,Male,Selangor,14,8,10,1,33,23,56,C
2018,2958,Male,Negeri Sembilan,17,8,6,1,32,31,63,B
2016,2959,Male,Perlis,16,7,7,5,35,25,60,B
2014,2960,Female,Selangor,20,6,9,3,38,22,60,B
2012,2961,Male,Perak,13,5,10,2,30,22,52,C
2014,2962,Female,Perak,14,8,10,2,34,31,65,B
2013,2963,Male,Malacca,15,3,8,3,29,38,67,B
2014,2964,Male,Terengganu,18,8,6,2,34,24,58,C
2019,2965,Female,Kelantan,20,7,3,1,31,37,68,B
2013,2966,Female,Perak,21,4,8,3,36,24,60,B
2018,2967,Female,Terengganu,20,10,4,1,35,25,60,B
2018,2968,Female,Kedah,18,4,9,4,35,39,74,B
2015,2969,Female,Kedah,13,10,4,3,30,35,65,B
2017,2970,Male,Penang,15,10,8,4,37,35,72,B
2018,2971,Female,Malacca,18,8,7,2,35,39,74,B
2016,2972,Female,Malacca,16,3,6,1,26,24,50,C
2014,2973,Male,Johor,19,4,6,4,33,37,70,B
2019,2974,Female,Perak,13,3,8,4,28,40,68,B
2016,2975,Female,Malacca,18,8,3,1,30,29,59,C
2014,2976,Male,Malacca,15,5,7,1,28,24,52,C
2019,2977,Male,Kelantan,15,3,7,4,29,25,54,C
2017,2978,Female,Kelantan,18,3,6,1,28,22,50,C
2014,2979,Female,Penang,20,5,3,4,32,27,59,C
2013,2980,Female,Perak,18,3,10,5,36,32,68,B
2015,2981,Female,Terengganu,18,10,8,2,38,22,60,B
2016,2982,Female,Perlis,17,3,8,3,31,22,53,C
2014,2983,Male,Selangor,18,5,10,2,35,39,74,B
2019,2984,Male,Negeri Sembilan,20,5,8,3,36,32,68,B
2017,2985,Female,Kedah,20,8,7,2,37,34,71,B
2013,2986,Male,Terengganu,17,6,4,2,29,32,61,B
2012,2987,Female,Perak,13,9,5,1,28,30,58,C
2017,2988,Male,Sabah,20,5,4,5,34,40,74,B
2019,2989,Male,Kedah,18,3,3,5,29,31,60,B
2017,2990,Male,Malacca,18,10,4,3,35,24,59,C
2014,2991,Male,Kedah,16,4,7,2,29,25,54,C
2013,2992,Male,Malacca,18,3,9,4,34,27,61,B
2016,2993,Female,Kelantan,17,3,5,5,30,29,59,C
2017,2994,Male,Terengganu,15,9,6,4,34,36,70,B
2016,2995,Male,Kelantan,21,9,5,5,40,35,75,B
2012,2996,Female,Perak,15,3,4,3,25,26,51,C
2019,2997,Female,Pahang,19,4,7,3,33,40,73,B
2012,2998,Male,Terengganu,21,4,7,1,33,22,55,C
2019,2999,Female,Perak,14,6,9,2,31,35,66,B
2019,3000,Female,Johor,16,3,10,2,31,30,61,B
2014,3001,Female,Johor,14,7,6,5,32,38,70,B
2016,3002,Male,Terengganu,14,3,3,4,24,33,57,C
2014,3003,Male,Kelantan,14,9,3,4,30,34,64,B
2018,3004,Male,Negeri Sembilan,14,9,6,1,30,36,66,B
2019,3005,Female,Sarawak,14,10,4,5,33,34,67,B
2013,3006,Female,Terengganu,13,6,6,4,29,28,57,C
2018,3007,Female,Pahang,13,10,8,3,34,23,57,C
2019,3008,Female,Perlis,21,10,6,2,39,28,67,B
2014,3009,Male,Kelantan,21,8,9,4,42,35,77,B
2013,3010,Male,Perak,13,4,10,3,30,33,63,B
2015,3011,Female,Kelantan,17,5,8,4,34,37,71,B
2016,3012,Female,Kedah,18,3,10,2,33,23,56,C
2019,3013,Male,Pahang,15,7,9,1,32,34,66,B
2019,3014,Female,Selangor,20,10,5,1,36,35,71,B
2016,3015,Male,Penang,15,9,8,1,33,36,69,B
2016,3016,Female,Sabah,16,4,4,4,28,26,54,C
2016,3017,Male,Kelantan,21,3,7,5,36,34,70,B
2019,3018,Male,Sabah,15,6,7,4,32,30,62,B
2019,3019,Female,Perak,21,4,7,2,34,34,68,B
2018,3020,Male,Sabah,17,3,8,2,30,40,70,B
2014,3021,Male,Penang,19,9,6,3,37,31,68,B
2014,3022,Female,Sabah,19,5,4,4,32,30,62,B
2013,3023,Male,Negeri Sembilan,13,8,6,4,31,40,71,B
2013,3024,Female,Terengganu,14,5,4,3,26,22,48,F
2014,3025,Female,Penang,15,5,6,5,31,23,54,C
2013,3026,Male,Penang,18,7,8,3,36,40,76,B
2017,3027,Female,Sabah,21,6,4,2,33,29,62,B
2015,3028,Male,Sabah,21,3,9,5,38,28,66,B
2014,3029,Male,Kelantan,19,5,5,2,31,31,62,B
2014,3030,Female,Perak,16,8,10,3,37,40,77,B
2016,3031,Male,Sarawak,21,10,7,1,39,33,72,B
2017,3032,Female,Kedah,16,4,3,4,27,35,62,B
2018,3033,Female,Perak,19,3,4,2,28,35,63,B
2014,3034,Male,Sarawak,14,4,6,2,26,25,51,C
2018,3035,Female,Sarawak,13,9,6,1,29,32,61,B
2017,3036,Male,Perlis,18,10,6,1,35,39,74,B
2013,3037,Female,Negeri Sembilan,15,10,3,5,33,31,64,B
2012,3038,Female,Sabah,14,5,7,3,29,24,53,C
2019,3039,Female,Selangor,21,9,4,1,35,29,64,B
2014,3040,Male,Sabah,13,4,7,5,29,36,65,B
2014,3041,Female,Terengganu,18,8,7,4,37,35,72,B
2012,3042,Female,Perak,17,4,3,4,28,29,57,C
2018,3043,Male,Malacca,21,8,3,4,36,26,62,B
2016,3044,Male,Malacca,21,9,6,1,37,34,71,B
2019,3045,Male,Terengganu,19,6,5,4,34,22,56,C
2015,3046,Male,Terengganu,13,6,8,4,31,29,60,B
2019,3047,Male,Penang,15,6,9,4,34,33,67,B
2015,3048,Female,Johor,13,10,3,2,28,32,60,B
2018,3049,Female,Penang,13,3,4,3,23,28,51,C
2014,3050,Male,Johor,21,4,8,2,35,36,71,B
2019,3051,Male,Perlis,16,9,3,4,32,28,60,B
2015,3052,Female,Terengganu,16,7,6,3,32,32,64,B
2017,3053,Male,Johor,13,3,9,4,29,38,67,B
2015,3054,Male,Pahang,18,10,8,3,39,24,63,B
2019,3055,Male,Sarawak,21,5,6,1,33,31,64,B
2015,3056,Female,Malacca,17,7,9,1,34,24,58,C
2012,3057,Female,Johor,17,8,7,5,37,37,74,B
2012,3058,Female,Kedah,14,9,8,3,34,25,59,C
2014,3059,Female,Pahang,17,5,8,3,33,40,73,B
2015,3060,Male,Johor,17,7,10,3,37,27,64,B
2013,3061,Male,Kedah,19,9,6,3,37,37,74,B
2019,3062,Male,Negeri Sembilan,18,10,5,2,35,26,61,B
2015,3063,Female,Perlis,18,9,9,2,38,31,69,B
2015,3064,Female,Johor,16,3,10,4,33,34,67,B
2014,3065,Male,Selangor,17,8,4,4,33,26,59,C
2013,3066,Female,Terengganu,13,5,6,1,25,27,52,C
2015,3067,Female,Malacca,15,7,9,2,33,39,72,B
2013,3068,Male,Penang,15,7,9,4,35,40,75,B
2014,3069,Female,Penang,21,8,10,5,44,29,73,B
2014,3070,Male,Selangor,16,9,6,3,34,23,57,C
2013,3071,Female,Terengganu,20,4,5,1,30,22,52,C
2013,3072,Male,Penang,17,3,5,2,27,31,58,C
2015,3073,Female,Sabah,20,5,7,2,34,34,68,B
2012,3074,Male,Perlis,17,8,4,4,33,35,68,B
2017,3075,Female,Terengganu,17,3,7,5,32,29,61,B
2017,3076,Male,Sarawak,14,6,10,2,32,25,57,C
2016,3077,Female,Kedah,19,4,8,1,32,29,61,B
2015,3078,Male,Negeri Sembilan,13,9,8,2,32,40,72,B
2015,3079,Male,Malacca,20,7,3,4,34,27,61,B
2019,3080,Female,Penang,20,10,5,2,37,28,65,B
2013,3081,Male,Sabah,16,8,5,4,33,27,60,B
2014,3082,Male,Malacca,13,3,8,4,28,39,67,B
2014,3083,Female,Selangor,21,4,7,2,34,35,69,B
2012,3084,Male,Johor,18,6,9,5,38,24,62,B
2014,3085,Male,Penang,14,6,10,3,33,26,59,C
2018,3086,Female,Pahang,14,4,5,1,24,34,58,C
2015,3087,Female,Johor,17,7,4,1,29,24,53,C
2018,3088,Male,Perak,19,10,4,5,38,35,73,B
2016,3089,Female,Selangor,17,4,3,5,29,38,67,B
2015,3090,Male,Malacca,14,5,7,3,29,23,52,C
2012,3091,Female,Penang,14,4,7,1,26,37,63,B
2017,3092,Male,Perlis,18,7,7,3,35,28,63,B
2017,3093,Female,Malacca,16,7,4,1,28,29,57,C
2012,3094,Male,Johor,17,9,7,1,34,30,64,B
2016,3095,Male,Perlis,18,9,5,3,35,34,69,B
2013,3096,Male,Sabah,16,9,4,3,32,39,71,B
2016,3097,Male,Sabah,17,7,8,3,35,27,62,B
2013,3098,Male,Perlis,15,5,5,3,28,27,55,C
2013,3099,Male,Perak,17,5,10,2,34,37,71,B
2018,3100,Male,Perak,20,9,5,4,38,31,69,B
2015,3101,Male,Pahang,13,10,5,5,33,36,69,B
2017,3102,Male,Johor,21,9,7,4,41,33,74,B
2015,3103,Male,Penang,21,6,6,2,35,31,66,B
2015,3104,Female,Kelantan,16,7,7,3,33,40,73,B
2018,3105,Male,Kelantan,20,5,4,5,34,30,64,B
2016,3106,Male,Penang,15,6,6,4,31,34,65,B
2012,3107,Male,Penang,17,10,9,2,38,25,63,B
2012,3108,Female,Penang,21,6,10,5,42,32,74,B
2013,3109,Male,Malacca,20,4,7,3,34,37,71,B
2012,3110,Female,Kedah,20,5,7,3,35,40,75,B
2014,3111,Female,Perak,20,7,5,2,34,34,68,B
2012,3112,Male,Sarawak,20,3,6,5,34,39,73,B
2014,3113,Female,Malacca,16,8,3,2,29,29,58,C
2012,3114,Male,Pahang,14,7,9,5,35,39,74,B
2017,3115,Male,Johor,21,9,6,1,37,36,73,B
2012,3116,Female,Perak,20,5,3,3,31,31,62,B
2012,3117,Male,Sabah,14,4,5,3,26,28,54,C
2019,3118,Male,Kedah,19,7,7,5,38,26,64,B
2018,3119,Male,Negeri Sembilan,20,3,7,3,33,22,55,C
2018,3120,Male,Sabah,21,6,4,4,35,32,67,B
2016,3121,Female,Penang,19,8,8,3,38,31,69,B
2014,3122,Male,Kedah,20,3,6,3,32,24,56,C
2012,3123,Male,Selangor,16,7,6,5,34,37,71,B
2018,3124,Female,Selangor,17,5,3,1,26,35,61,B
2014,3125,Female,Kedah,16,7,3,4,30,37,67,B
2015,3126,Female,Malacca,18,4,10,1,33,31,64,B
2019,3127,Male,Pahang,21,7,6,5,39,39,78,B
2015,3128,Male,Sarawak,18,5,5,3,31,33,64,B
2017,3129,Male,Sabah,19,3,7,3,32,32,64,B
2016,3130,Female,Penang,18,7,8,1,34,40,74,B
2018,3131,Female,Malacca,21,6,8,3,38,38,76,B
2018,3132,Male,Negeri Sembilan,19,8,8,5,40,27,67,B
2012,3133,Male,Selangor,17,3,10,5,35,36,71,B
2012,3134,Female,Sarawak,16,7,5,5,33,37,70,B
2013,3135,Male,Kedah,18,3,10,1,32,35,67,B
2013,3136,Female,Sabah,14,6,6,1,27,40,67,B
2019,3137,Female,Johor,17,4,7,1,29,40,69,B
2013,3138,Female,Perlis,16,7,5,1,29,24,53,C
2012,3139,Female,Perak,13,3,5,1,22,38,60,B
2018,3140,Female,Johor,21,7,6,5,39,35,74,B
2016,3141,Male,Sabah,18,3,6,1,28,33,61,B
2018,3142,Male,Selangor,15,3,3,4,25,30,55,C
2015,3143,Female,Sarawak,16,3,3,5,27,32,59,C
2016,3144,Female,Malacca,13,4,8,3,28,23,51,C
2018,3145,Female,Perak,18,4,8,1,31,31,62,B
2012,3146,Male,Kelantan,18,4,7,4,33,36,69,B
2015,3147,Male,Perak,17,8,10,2,37,32,69,B
2014,3148,Female,Negeri Sembilan,19,9,3,4,35,36,71,B
2016,3149,Female,Sarawak,21,8,5,4,38,25,63,B
2016,3150,Male,Kedah,15,5,3,1,24,27,51,C
2012,3151,Male,Johor,19,8,9,3,39,37,76,B
2015,3152,Male,Sarawak,19,7,4,5,35,38,73,B
2017,3153,Female,Kelantan,20,10,3,5,38,34,72,B
2014,3154,Female,Kelantan,13,7,4,5,29,29,58,C
2013,3155,Female,Pahang,14,4,6,5,29,39,68,B
2012,3156,Female,Perak,20,6,4,2,32,38,70,B
2016,3157,Male,Penang,14,4,8,5,31,28,59,C
2018,3158,Male,Sarawak,13,10,8,2,33,38,71,B
2019,3159,Female,Kedah,15,6,3,5,29,29,58,C
2016,3160,Female,Sabah,18,9,10,2,39,33,72,B
2019,3161,Male,Negeri Sembilan,13,6,7,4,30,27,57,C
2012,3162,Female,Sabah,13,4,9,2,28,36,64,B
2016,3163,Female,Kedah,17,7,8,2,34,31,65,B
2019,3164,Female,Kedah,20,10,8,2,40,29,69,B
2019,3165,Female,Malacca,17,3,10,3,33,30,63,B
2012,3166,Male,Kelantan,15,9,4,1,29,33,62,B
2019,3167,Male,Malacca,15,7,10,4,36,25,61,B
2019,3168,Female,Selangor,17,9,8,2,36,32,68,B
2014,3169,Female,Sarawak,16,7,5,3,31,37,68,B
2017,3170,Male,Perlis,14,4,8,2,28,27,55,C
2018,3171,Male,Sarawak,15,3,8,3,29,36,65,B
2017,3172,Female,Johor,14,10,3,1,28,29,57,C
2013,3173,Female,Perak,18,3,7,1,29,40,69,B
2014,3174,Female,Penang,14,7,5,5,31,27,58,C
2014,3175,Female,Perlis,14,8,6,1,29,23,52,C
2018,3176,Female,Perak,17,10,10,3,40,40,80,A
2019,3177,Male,Penang,16,6,4,5,31,37,68,B
2019,3178,Female,Penang,13,8,5,3,29,33,62,B
2018,3179,Female,Pahang,20,10,8,2,40,22,62,B
2015,3180,Male,Perak,17,9,4,4,34,37,71,B
2013,3181,Female,Negeri Sembilan,17,5,10,3,35,23,58,C
2016,3182,Female,Sarawak,21,10,5,5,41,40,81,A
2014,3183,Female,Terengganu,19,9,9,3,40,23,63,B
2019,3184,Female,Penang,14,3,8,3,28,40,68,B
2014,3185,Male,Penang,16,5,5,4,30,23,53,C
2016,3186,Female,Terengganu,17,4,10,5,36,28,64,B
2012,3187,Male,Pahang,16,6,5,3,30,26,56,C
2017,3188,Male,Terengganu,19,6,6,1,32,26,58,C
2014,3189,Female,Pahang,20,8,7,5,40,36,76,B
2013,3190,Female,Selangor,21,6,6,5,38,22,60,B
2012,3191,Female,Kelantan,19,4,5,2,30,38,68,B
2013,3192,Male,Negeri Sembilan,17,4,6,2,29,40,69,B
2019,3193,Male,Kedah,20,9,3,5,37,38,75,B
2017,3194,Male,Kelantan,18,6,10,4,38,34,72,B
2018,3195,Female,Johor,14,8,10,1,33,30,63,B
2013,3196,Male,Negeri Sembilan,16,6,3,1,26,39,65,B
2019,3197,Male,Kelantan,19,9,10,2,40,26,66,B
2012,3198,Male,Selangor,21,6,9,2,38,27,65,B
2015,3199,Female,Perlis,13,5,7,5,30,28,58,C
2013,3200,Male,Malacca,13,9,4,1,27,24,51,C
2017,3201,Female,Kelantan,16,6,8,2,32,32,64,B
2015,3202,Female,Sarawak,13,9,7,5,34,31,65,B
2018,3203,Female,Perak,19,10,9,5,43,26,69,B
2016,3204,Male,Terengganu,16,4,3,3,26,40,66,B
2015,3205,Female,Terengganu,16,8,7,3,34,31,65,B
2012,3206,Male,Kedah,16,10,9,2,37,38,75,B
2014,3207,Female,Selangor,19,6,9,5,39,36,75,B
2017,3208,Male,Penang,18,8,7,1,34,29,63,B
2019,3209,Female,Malacca,18,7,10,4,39,27,66,B
2016,3210,Male,Perak,19,5,10,4,38,22,60,B
2019,3211,Female,Sabah,16,7,4,5,32,31,63,B
2012,3212,Male,Kelantan,20,3,4,5,32,22,54,C
2017,3213,Female,Penang,15,7,4,5,31,40,71,B
2012,3214,Female,Pahang,14,8,4,4,30,29,59,C
2015,3215,Female,Malacca,18,5,6,4,33,38,71,B
2018,3216,Female,Sarawak,17,6,9,3,35,30,65,B
2014,3217,Male,Pahang,18,10,7,5,40,31,71,B
2015,3218,Female,Kelantan,20,8,3,3,34,39,73,B
2015,3219,Male,Selangor,20,10,9,5,44,29,73,B
2014,3220,Male,Negeri Sembilan,16,4,9,4,33,25,58,C
2012,3221,Male,Perlis,15,8,10,5,38,40,78,B
2012,3222,Male,Terengganu,16,6,7,2,31,22,53,C
2016,3223,Female,Perak,19,4,9,5,37,26,63,B
2016,3224,Female,Perlis,14,9,7,2,32,39,71,B
2018,3225,Female,Negeri Sembilan,21,10,4,4,39,25,64,B
2013,3226,Female,Selangor,17,6,8,2,33,23,56,C
2019,3227,Male,Negeri Sembilan,13,4,8,4,29,28,57,C
2015,3228,Female,Pahang,16,6,7,4,33,24,57,C
2019,3229,Male,Penang,17,9,8,1,35,28,63,B
2013,3230,Female,Johor,17,6,7,3,33,24,57,C
2016,3231,Male,Negeri Sembilan,20,7,9,2,38,25,63,B
2014,3232,Male,Kedah,18,10,10,4,42,34,76,B
2012,3233,Female,Negeri Sembilan,15,6,5,1,27,23,50,C
2018,3234,Female,Terengganu,17,8,10,5,40,23,63,B
2014,3235,Male,Pahang,19,8,3,1,31,30,61,B
2014,3236,Male,Terengganu,16,7,4,5,32,32,64,B
2015,3237,Female,Johor,16,7,6,2,31,34,65,B
2013,3238,Female,Penang,20,10,8,4,42,27,69,B
2016,3239,Female,Negeri Sembilan,19,8,4,2,33,29,62,B
2013,3240,Male,Sabah,20,9,8,4,41,32,73,B
2015,3241,Male,Kelantan,16,9,7,1,33,34,67,B
2019,3242,Female,Malacca,15,5,4,2,26,37,63,B
2012,3243,Female,Kelantan,19,10,6,2,37,29,66,B
2018,3244,Male,Kelantan,20,3,4,3,30,27,57,C
2018,3245,Female,Negeri Sembilan,17,5,9,5,36,38,74,B
2012,3246,Male,Kedah,21,7,5,3,36,32,68,B
2014,3247,Male,Kedah,21,6,6,5,38,31,69,B
2014,3248,Male,Johor,17,10,4,2,33,25,58,C
2012,3249,Male,Perak,18,10,9,1,38,29,67,B
2015,3250,Male,Terengganu,18,8,4,5,35,22,57,C
2013,3251,Female,Sarawak,14,10,6,4,34,30,64,B
2016,3252,Female,Penang,21,7,5,4,37,32,69,B
2012,3253,Male,Terengganu,20,9,8,2,39,25,64,B
2012,3254,Male,Pahang,20,7,7,3,37,33,70,B
2017,3255,Male,Penang,17,5,10,2,34,40,74,B
2015,3256,Male,Perlis,20,7,4,5,36,29,65,B
2012,3257,Female,Negeri Sembilan,18,7,10,1,36,33,69,B
2018,3258,Female,Penang,17,6,3,1,27,34,61,B
2013,3259,Female,Sabah,14,10,3,5,32,25,57,C
2012,3260,Male,Malacca,15,3,6,2,26,31,57,C
2012,3261,Male,Johor,13,4,9,2,28,37,65,B
2017,3262,Male,Terengganu,14,9,6,3,32,39,71,B
2012,3263,Male,Sabah,18,7,9,2,36,27,63,B
2017,3264,Female,Penang,14,3,4,1,22,37,59,C
2018,3265,Male,Sabah,19,7,9,4,39,24,63,B
2015,3266,Female,Negeri Sembilan,15,4,10,4,33,34,67,B
2013,3267,Female,Negeri Sembilan,16,8,10,1,35,26,61,B
2013,3268,Female,Johor,18,9,6,2,35,38,73,B
2014,3269,Female,Johor,18,6,6,3,33,27,60,B
2018,3270,Female,Sarawak,21,9,5,4,39,36,75,B
2012,3271,Female,Johor,20,5,6,5,36,37,73,B
2017,3272,Male,Johor,13,7,3,5,28,29,57,C
2017,3273,Male,Perlis,19,6,6,3,34,28,62,B
2014,3274,Male,Sabah,18,3,5,4,30,37,67,B
2017,3275,Female,Kedah,19,5,6,4,34,30,64,B
2019,3276,Male,Perlis,19,7,3,1,30,22,52,C
2017,3277,Male,Johor,18,3,10,1,32,34,66,B
2019,3278,Female,Sabah,21,10,6,3,40,40,80,A
2018,3279,Male,Pahang,19,9,10,2,40,36,76,B
2016,3280,Female,Pahang,16,6,3,4,29,33,62,B
2017,3281,Female,Sabah,21,8,9,2,40,27,67,B
2013,3282,Male,Terengganu,13,7,9,3,32,38,70,B
2018,3283,Male,Penang,13,6,9,2,30,31,61,B
2013,3284,Female,Perlis,17,9,6,5,37,40,77,B
2016,3285,Female,Kelantan,21,8,4,2,35,24,59,C
2018,3286,Male,Malacca,18,8,9,2,37,25,62,B
2012,3287,Male,Kedah,20,3,6,4,33,40,73,B
2013,3288,Female,Terengganu,20,5,9,5,39,33,72,B
2015,3289,Male,Pahang,13,8,7,2,30,28,58,C
2016,3290,Male,Selangor,17,4,5,1,27,32,59,C
2018,3291,Female,Malacca,18,10,7,1,36,23,59,C
2016,3292,Male,Penang,21,6,5,5,37,33,70,B
2013,3293,Male,Terengganu,19,6,5,1,31,27,58,C
2015,3294,Female,Malacca,16,8,6,2,32,40,72,B
2014,3295,Male,Perak,13,3,3,5,24,30,54,C
2013,3296,Male,Perak,17,8,9,2,36,36,72,B
2017,3297,Female,Selangor,14,5,9,4,32,22,54,C
2015,3298,Male,Malacca,17,4,6,1,28,28,56,C
2014,3299,Female,Selangor,14,6,6,4,30,31,61,B
2012,3300,Female,Terengganu,21,4,8,3,36,24,60,B
2014,3301,Male,Perak,15,10,10,3,38,27,65,B
2017,3302,Female,Johor,17,7,8,2,34,34,68,B
2015,3303,Female,Sarawak,21,5,6,3,35,31,66,B
2014,3304,Male,Pahang,13,6,9,1,29,28,57,C
2013,3305,Male,Johor,20,7,6,3,36,37,73,B
2012,3306,Female,Perak,17,6,9,1,33,26,59,C
2012,3307,Female,Sabah,17,5,9,1,32,39,71,B
2015,3308,Female,Kelantan,16,10,7,1,34,27,61,B
2014,3309,Male,Penang,13,3,9,2,27,37,64,B
2013,3310,Male,Terengganu,18,8,7,3,36,26,62,B
2019,3311,Male,Selangor,14,5,4,4,27,40,67,B
2018,3312,Male,Terengganu,14,5,5,5,29,23,52,C
2017,3313,Male,Pahang,21,3,6,2,32,37,69,B
2017,3314,Male,Sabah,19,4,8,2,33,33,66,B
2012,3315,Male,Sabah,18,9,4,3,34,32,66,B
2016,3316,Female,Negeri Sembilan,13,9,7,3,32,37,69,B
2013,3317,Male,Kelantan,13,10,7,5,35,33,68,B
2013,3318,Female,Kedah,18,3,6,3,30,31,61,B
2017,3319,Male,Malacca,14,6,8,5,33,28,61,B
2018,3320,Male,Penang,14,4,10,4,32,28,60,B
2013,3321,Female,Perak,16,4,9,2,31,40,71,B
2019,3322,Male,Sabah,14,5,7,1,27,30,57,C
2017,3323,Male,Johor,20,10,3,5,38,31,69,B
2019,3324,Male,Negeri Sembilan,19,5,4,4,32,24,56,C
2016,3325,Female,Sabah,15,3,4,4,26,32,58,C
2013,3326,Male,Sarawak,21,5,4,5,35,34,69,B
2018,3327,Male,Johor,21,7,10,3,41,38,79,A
2014,3328,Female,Negeri Sembilan,20,10,5,4,39,38,77,B
2017,3329,Female,Sarawak,17,9,9,5,40,27,67,B
2018,3330,Female,Kedah,21,4,3,3,31,22,53,C
2014,3331,Male,Johor,20,4,6,2,32,35,67,B
2012,3332,Male,Kelantan,21,5,7,2,35,39,74,B
2015,3333,Female,Perlis,20,8,8,3,39,29,68,B
2016,3334,Male,Kelantan,15,10,3,4,32,33,65,B
2017,3335,Male,Perlis,19,9,3,5,36,28,64,B
2012,3336,Female,Kedah,13,6,8,5,32,23,55,C
2017,3337,Male,Negeri Sembilan,18,5,8,3,34,27,61,B
2018,3338,Male,Selangor,21,3,4,2,30,31,61,B
2016,3339,Female,Perak,20,5,10,4,39,37,76,B
2014,3340,Female,Perak,13,8,3,4,28,38,66,B
2017,3341,Female,Pahang,20,4,8,4,36,32,68,B
2018,3342,Male,Terengganu,16,7,8,2,33,34,67,B
2017,3343,Male,Sarawak,15,9,4,5,33,29,62,B
2013,3344,Female,Sabah,13,9,9,1,32,31,63,B
2014,3345,Female,Kelantan,18,8,4,5,35,24,59,C
2017,3346,Male,Terengganu,13,6,7,3,29,26,55,C
2015,3347,Male,Kelantan,16,5,6,4,31,34,65,B
2012,3348,Male,Kelantan,15,5,8,2,30,40,70,B
2015,3349,Male,Perak,13,4,10,3,30,22,52,C
2015,3350,Female,Malacca,17,3,3,5,28,37,65,B
2019,3351,Male,Johor,21,8,8,3,40,38,78,B
2015,3352,Male,Pahang,13,3,4,2,22,35,57,C
2014,3353,Female,Johor,17,9,5,2,33,22,55,C
2016,3354,Male,Terengganu,16,6,7,2,31,25,56,C
2016,3355,Male,Malacca,14,8,8,5,35,22,57,C
2016,3356,Male,Sarawak,18,4,10,4,36,24,60,B
2019,3357,Female,Pahang,13,7,6,4,30,29,59,C
2013,3358,Male,Perak,14,5,7,1,27,30,57,C
2015,3359,Male,Perlis,16,4,5,5,30,27,57,C
2017,3360,Male,Kedah,20,8,6,2,36,38,74,B
2012,3361,Female,Perak,13,5,4,4,26,22,48,F
2018,3362,Male,Perak,18,7,10,1,36,34,70,B
2019,3363,Male,Sabah,17,9,3,4,33,26,59,C
2016,3364,Male,Negeri Sembilan,17,10,3,4,34,40,74,B
2017,3365,Male,Sabah,16,3,4,1,24,34,58,C
2019,3366,Male,Negeri Sembilan,20,10,6,2,38,26,64,B
2013,3367,Male,Perlis,21,5,7,4,37,28,65,B
2017,3368,Female,Negeri Sembilan,18,6,8,4,36,29,65,B
2012,3369,Male,Kelantan,15,4,6,1,26,25,51,C
2018,3370,Female,Malacca,16,9,6,1,32,29,61,B
2017,3371,Male,Perak,18,3,3,1,25,28,53,C
2018,3372,Male,Kelantan,14,7,5,4,30,38,68,B
2012,3373,Female,Negeri Sembilan,13,10,10,5,38,25,63,B
2013,3374,Male,Penang,13,4,8,5,30,31,61,B
2018,3375,Female,Kedah,13,9,9,4,35,36,71,B
2019,3376,Male,Kelantan,20,9,9,2,40,39,79,A
2013,3377,Male,Pahang,21,5,4,1,31,22,53,C
2017,3378,Male,Sabah,17,6,9,5,37,24,61,B
2015,3379,Female,Johor,18,9,8,5,40,37,77,B
2012,3380,Male,Selangor,21,9,6,3,39,38,77,B
2014,3381,Female,Terengganu,19,8,4,4,35,32,67,B
2017,3382,Male,Sabah,15,9,8,2,34,30,64,B
2018,3383,Male,Selangor,20,3,7,2,32,27,59,C
2019,3384,Female,Sarawak,18,9,6,5,38,27,65,B
2014,3385,Female,Perlis,21,4,7,4,36,38,74,B
2013,3386,Female,Sarawak,13,6,9,4,32,23,55,C
2016,3387,Male,Perlis,19,5,4,1,29,22,51,C
2016,3388,Female,Perlis,15,3,7,5,30,25,55,C
2015,3389,Female,Malacca,20,3,10,2,35,40,75,B
2015,3390,Female,Selangor,21,4,9,3,37,29,66,B
2017,3391,Male,Perak,20,3,9,1,33,25,58,C
2015,3392,Male,Sabah,19,5,3,2,29,40,69,B
2016,3393,Male,Malacca,20,5,9,5,39,24,63,B
2013,3394,Female,Sabah,15,7,9,3,34,33,67,B
2017,3395,Female,Terengganu,20,3,3,2,28,34,62,B
2018,3396,Male,Perak,19,4,7,3,33,33,66,B
2019,3397,Male,Selangor,15,9,5,4,33,33,66,B
2019,3398,Male,Penang,15,6,7,4,32,34,66,B
2014,3399,Male,Kelantan,18,5,9,2,34,39,73,B
2015,3400,Female,Selangor,13,4,3,3,23,23,46,F
2015,3401,Male,Malacca,19,6,6,3,34,29,63,B
2018,3402,Female,Kedah,16,5,5,4,30,38,68,B
2018,3403,Female,Negeri Sembilan,18,4,5,2,29,38,67,B
2013,3404,Male,Johor,19,3,3,2,27,25,52,C
2019,3405,Male,Malacca,14,8,8,5,35,36,71,B
2019,3406,Male,Selangor,13,4,7,1,25,22,47,F
2012,3407,Male,Malacca,21,8,8,1,38,27,65,B
2013,3408,Female,Sarawak,17,8,5,5,35,28,63,B
2015,3409,Male,Penang,21,9,5,4,39,27,66,B
2014,3410,Female,Penang,18,4,10,5,37,30,67,B
2015,3411,Male,Perak,21,9,3,5,38,25,63,B
2018,3412,Female,Sabah,17,5,3,5,30,22,52,C
2013,3413,Female,Sabah,15,6,8,4,33,37,70,B
2016,3414,Female,Kelantan,14,7,7,5,33,27,60,B
2014,3415,Male,Malacca,14,9,4,5,32,33,65,B
2014,3416,Female,Selangor,15,8,9,1,33,27,60,B
2018,3417,Male,Penang,17,8,8,2,35,36,71,B
2013,3418,Female,Sabah,14,10,4,2,30,23,53,C
2015,3419,Female,Johor,19,7,7,2,35,26,61,B
2019,3420,Male,Perak,16,5,4,5,30,28,58,C
2014,3421,Female,Perak,14,8,10,5,37,40,77,B
2013,3422,Female,Kedah,18,4,4,3,29,27,56,C
2012,3423,Male,Malacca,19,7,10,5,41,22,63,B
2019,3424,Male,Negeri Sembilan,18,5,3,3,29,33,62,B
2017,3425,Female,Terengganu,16,7,5,5,33,34,67,B
2014,3426,Female,Kedah,17,8,9,2,36,34,70,B
2015,3427,Male,Terengganu,19,8,9,4,40,29,69,B
2018,3428,Female,Terengganu,15,9,4,2,30,36,66,B
2017,3429,Male,Sarawak,20,4,6,2,32,28,60,B
2016,3430,Female,Terengganu,16,3,9,1,29,31,60,B
2014,3431,Male,Perak,15,8,5,1,29,23,52,C
2016,3432,Female,Johor,15,5,7,2,29,35,64,B
2019,3433,Male,Kedah,20,8,8,3,39,27,66,B
2017,3434,Female,Negeri Sembilan,13,6,4,2,25,29,54,C
2013,3435,Female,Negeri Sembilan,16,4,7,4,31,39,70,B
2019,3436,Male,Kedah,18,8,5,2,33,33,66,B
2013,3437,Male,Terengganu,16,9,4,5,34,25,59,C
2019,3438,Female,Sarawak,14,6,4,5,29,30,59,C
2017,3439,Female,Kelantan,13,7,8,3,31,30,61,B
2014,3440,Female,Kelantan,20,9,4,2,35,22,57,C
2016,3441,Female,Kelantan,17,9,8,3,37,39,76,B
2013,3442,Female,Kedah,18,10,8,3,39,25,64,B
2013,3443,Female,Selangor,13,3,5,3,24,35,59,C
2016,3444,Male,Sarawak,13,4,3,2,22,23,45,F
2017,3445,Female,Johor,20,3,6,4,33,36,69,B
2015,3446,Female,Terengganu,21,10,10,1,42,28,70,B
2018,3447,Female,Johor,19,4,8,1,32,22,54,C
2016,3448,Female,Negeri Sembilan,20,6,10,3,39,22,61,B
2012,3449,Female,Kelantan,17,9,5,2,33,29,62,B
2016,3450,Male,Penang,21,9,5,1,36,33,69,B
2015,3451,Female,Kelantan,19,10,10,4,43,35,78,B
2014,3452,Female,Johor,19,9,3,3,34,37,71,B
2012,3453,Female,Pahang,16,6,7,1,30,22,52,C
2015,3454,Female,Sarawak,18,8,3,4,33,28,61,B
2012,3455,Male,Selangor,16,10,8,3,37,40,77,B
2017,3456,Female,Johor,17,7,6,2,32,32,64,B
2019,3457,Female,Sarawak,21,10,8,4,43,25,68,B
2014,3458,Female,Johor,17,6,4,2,29,30,59,C
2014,3459,Female,Negeri Sembilan,16,3,9,4,32,25,57,C
2012,3460,Male,Johor,17,9,7,1,34,37,71,B
2019,3461,Male,Kedah,16,8,6,2,32,30,62,B
2012,3462,Male,Sarawak,13,6,10,2,31,36,67,B
2014,3463,Female,Perak,21,7,5,3,36,30,66,B
2019,3464,Male,Pahang,18,8,6,1,33,24,57,C
2016,3465,Male,Sabah,16,4,10,4,34,31,65,B
2018,3466,Male,Sarawak,17,10,6,1,34,37,71,B
2014,3467,Male,Terengganu,16,6,5,3,30,35,65,B
2016,3468,Male,Perak,16,6,5,2,29,36,65,B
2012,3469,Male,Sabah,13,3,7,1,24,32,56,C
2017,3470,Male,Sabah,13,3,3,5,24,33,57,C
2015,3471,Female,Terengganu,15,6,4,5,30,35,65,B
2012,3472,Male,Penang,15,4,10,3,32,28,60,B
2017,3473,Female,Selangor,14,5,4,1,24,31,55,C
2015,3474,Female,Penang,19,6,8,4,37,22,59,C
2014,3475,Male,Terengganu,17,10,10,1,38,38,76,B
2018,3476,Male,Johor,20,8,8,4,40,29,69,B
2019,3477,Male,Sarawak,17,10,8,1,36,29,65,B
2019,3478,Male,Kedah,20,8,10,2,40,39,79,A
2013,3479,Male,Malacca,21,10,10,1,42,33,75,B
2014,3480,Male,Pahang,16,3,3,3,25,36,61,B
2016,3481,Male,Terengganu,16,10,7,5,38,28,66,B
2016,3482,Male,Selangor,20,3,8,3,34,27,61,B
2014,3483,Male,Pahang,21,7,10,1,39,28,67,B
2019,3484,Male,Kedah,21,4,7,4,36,38,74,B
2019,3485,Male,Sarawak,16,3,5,3,27,26,53,C
2018,3486,Female,Malacca,17,8,5,2,32,30,62,B
2014,3487,Male,Terengganu,21,10,10,2,43,23,66,B
2016,3488,Female,Johor,14,9,7,2,32,31,63,B
2017,3489,Male,Malacca,17,10,3,3,33,30,63,B
2017,3490,Female,Malacca,15,6,9,4,34,30,64,B
2016,3491,Male,Johor,21,10,5,3,39,25,64,B
2018,3492,Female,Johor,20,4,9,2,35,24,59,C
2013,3493,Male,Pahang,18,6,10,5,39,25,64,B
2015,3494,Female,Pahang,20,6,3,2,31,28,59,C
2012,3495,Male,Perak,17,7,3,5,32,31,63,B
2015,3496,Female,Perak,17,3,6,1,27,23,50,C
2019,3497,Male,Penang,19,10,9,3,41,35,76,B
2019,3498,Female,Perlis,21,3,9,1,34,27,61,B
2014,3499,Female,Pahang,14,6,7,3,30,26,56,C
2014,3500,Male,Selangor,20,6,8,4,38,35,73,B
2018,3501,Female,Selangor,17,7,7,1,32,30,62,B
2017,3502,Female,Penang,20,5,7,3,35,32,67,B
2013,3503,Male,Perak,14,4,6,4,28,33,61,B
2015,3504,Male,Kelantan,20,7,5,5,37,30,67,B
2012,3505,Male,Sabah,21,5,10,2,38,35,73,B
2013,3506,Male,Sabah,21,6,8,4,39,38,77,B
2016,3507,Female,Terengganu,18,10,10,1,39,39,78,B
2019,3508,Male,Kelantan,20,7,8,1,36,37,73,B
2019,3509,Female,Negeri Sembilan,16,5,6,3,30,28,58,C
2014,3510,Male,Pahang,14,7,6,1,28,27,55,C
2019,3511,Male,Perak,13,5,7,5,30,40,70,B
2019,3512,Male,Johor,14,3,6,4,27,34,61,B
2012,3513,Male,Johor,20,8,3,4,35,31,66,B
2013,3514,Male,Pahang,18,9,9,3,39,32,71,B
2014,3515,Female,Terengganu,13,9,6,3,31,34,65,B
2016,3516,Female,Sarawak,15,10,8,5,38,31,69,B
2016,3517,Male,Negeri Sembilan,15,5,4,5,29,36,65,B
2017,3518,Female,Malacca,15,6,7,4,32,39,71,B
2013,3519,Female,Penang,15,5,7,4,31,35,66,B
2018,3520,Female,Malacca,15,3,7,2,27,28,55,C
2018,3521,Male,Sarawak,15,7,7,3,32,32,64,B
2012,3522,Female,Kelantan,14,8,7,3,32,26,58,C
2018,3523,Male,Sarawak,13,3,3,2,21,29,50,C
2016,3524,Male,Negeri Sembilan,15,9,10,1,35,27,62,B
2015,3525,Female,Terengganu,20,7,7,4,38,26,64,B
2012,3526,Male,Perlis,20,7,9,2,38,35,73,B
2012,3527,Female,Penang,18,3,10,3,34,32,66,B
2013,3528,Female,Penang,19,9,8,4,40,23,63,B
2018,3529,Female,Pahang,18,9,10,4,41,33,74,B
2019,3530,Male,Sarawak,16,10,7,4,37,27,64,B
2015,3531,Female,Pahang,21,10,8,5,44,22,66,B
2016,3532,Female,Penang,18,3,10,3,34,40,74,B
2019,3533,Female,Malacca,15,9,3,2,29,30,59,C
2017,3534,Male,Kedah,20,9,8,5,42,39,81,A
2019,3535,Female,Perak,19,8,4,2,33,27,60,B
2013,3536,Male,Malacca,17,8,9,1,35,26,61,B
2012,3537,Male,Sarawak,15,6,6,2,29,28,57,C
2013,3538,Female,Malacca,20,7,7,4,38,33,71,B
2017,3539,Female,Kedah,20,7,4,5,36,39,75,B
2018,3540,Female,Pahang,16,10,5,5,36,39,75,B
2013,3541,Male,Perlis,17,9,9,5,40,22,62,B
2016,3542,Male,Sarawak,14,3,10,5,32,32,64,B
2019,3543,Male,Perak,21,9,7,2,39,39,78,B
2017,3544,Male,Kedah,20,9,5,2,36,31,67,B
2016,3545,Male,Malacca,21,5,3,4,33,22,55,C
2016,3546,Male,Malacca,15,5,10,4,34,35,69,B
2014,3547,Male,Perlis,20,5,5,3,33,31,64,B
2018,3548,Male,Malacca,17,10,4,4,35,32,67,B
2015,3549,Female,Johor,15,5,8,2,30,27,57,C
2015,3550,Male,Johor,21,5,6,3,35,29,64,B
2012,3551,Male,Perlis,20,4,4,3,31,31,62,B
2016,3552,Female,Pahang,13,7,8,3,31,31,62,B
2017,3553,Female,Pahang,13,4,5,4,26,22,48,F
2013,3554,Female,Kedah,20,5,5,3,33,34,67,B
2015,3555,Male,Terengganu,13,3,3,4,23,25,48,F
2018,3556,Male,Kelantan,21,6,5,2,34,24,58,C
2012,3557,Male,Perak,13,7,8,4,32,29,61,B
2013,3558,Male,Malacca,21,10,9,2,42,24,66,B
2014,3559,Female,Kedah,18,4,6,2,30,40,70,B
2015,3560,Male,Kelantan,18,4,10,3,35,27,62,B
2017,3561,Male,Sabah,13,7,5,5,30,22,52,C
2019,3562,Male,Johor,14,9,7,4,34,38,72,B
2018,3563,Male,Negeri Sembilan,16,10,6,4,36,26,62,B
2016,3564,Male,Johor,15,4,5,5,29,29,58,C
2018,3565,Male,Terengganu,20,4,4,2,30,35,65,B
2016,3566,Male,Johor,15,9,4,1,29,30,59,C
2014,3567,Female,Terengganu,14,3,8,2,27,37,64,B
2014,3568,Female,Sabah,19,9,8,5,41,38,79,A
2019,3569,Female,Penang,18,7,6,4,35,35,70,B
2013,3570,Female,Perak,13,9,3,5,30,30,60,B
2019,3571,Female,Johor,21,8,9,1,39,31,70,B
2017,3572,Male,Perak,17,7,10,4,38,25,63,B
2015,3573,Female,Sarawak,20,4,5,5,34,26,60,B
2016,3574,Male,Selangor,13,5,7,2,27,27,54,C
2016,3575,Male,Kelantan,20,7,5,3,35,32,67,B
2016,3576,Male,Pahang,17,10,3,1,31,33,64,B
2012,3577,Male,Perak,15,7,3,3,28,31,59,C
2017,3578,Male,Penang,21,5,8,5,39,40,79,A
2017,3579,Female,Sarawak,18,3,7,4,32,24,56,C
2018,3580,Male,Perak,13,10,7,4,34,23,57,C
2018,3581,Female,Negeri Sembilan,15,9,5,2,31,22,53,C
2012,3582,Female,Pahang,16,4,4,2,26,28,54,C
2017,3583,Female,Sarawak,14,8,10,3,35,34,69,B
2017,3584,Female,Kedah,21,9,3,1,34,30,64,B
2015,3585,Male,Johor,14,4,10,3,31,24,55,C
2016,3586,Male,Negeri Sembilan,18,7,6,1,32,30,62,B
2013,3587,Male,Negeri Sembilan,20,6,6,4,36,32,68,B
2018,3588,Female,Johor,15,9,9,3,36,40,76,B
2014,3589,Female,Penang,16,9,5,2,32,38,70,B
2016,3590,Male,Kelantan,21,4,8,5,38,27,65,B
2016,3591,Male,Penang,19,6,7,1,33,32,65,B
2014,3592,Male,Johor,17,5,4,5,31,27,58,C
2014,3593,Female,Selangor,16,9,9,5,39,40,79,A
2018,3594,Female,Terengganu,15,3,8,3,29,29,58,C
2017,3595,Male,Kedah,18,4,8,3,33,36,69,B
2015,3596,Male,Perlis,21,4,6,5,36,30,66,B
2017,3597,Male,Johor,18,8,7,3,36,35,71,B
2015,3598,Male,Sabah,17,5,9,4,35,34,69,B
2012,3599,Male,Kelantan,20,4,7,3,34,34,68,B
2016,3600,Male,Kedah,14,10,10,5,39,25,64,B
2018,3601,Male,Malacca,13,10,6,4,33,26,59,C
2018,3602,Male,Johor,15,8,4,5,32,22,54,C
2013,3603,Male,Johor,14,10,5,2,31,22,53,C
2018,3604,Male,Kelantan,20,8,10,4,42,24,66,B
2018,3605,Male,Sabah,13,6,9,4,32,38,70,B
2013,3606,Male,Selangor,13,5,6,3,27,36,63,B
2017,3607,Female,Malacca,18,3,9,1,31,40,71,B
2016,3608,Male,Selangor,20,8,7,5,40,28,68,B
2018,3609,Male,Penang,14,10,3,4,31,26,57,C
2019,3610,Male,Penang,18,5,6,2,31,35,66,B
2015,3611,Male,Perlis,16,5,6,2,29,22,51,C
2012,3612,Female,Sarawak,21,3,3,5,32,26,58,C
2018,3613,Female,Sabah,19,7,5,2,33,35,68,B
2019,3614,Male,Kelantan,15,7,9,4,35,39,74,B
2014,3615,Female,Pahang,19,3,5,3,30,31,61,B
2013,3616,Male,Perak,19,7,9,1,36,31,67,B
2018,3617,Male,Perlis,16,4,4,2,26,22,48,F
2013,3618,Male,Terengganu,19,9,10,4,42,31,73,B
2018,3619,Female,Malacca,15,3,10,3,31,33,64,B
2014,3620,Male,Negeri Sembilan,13,3,5,3,24,33,57,C
2018,3621,Female,Kedah,21,6,4,4,35,33,68,B
2015,3622,Male,Terengganu,16,10,9,1,36,38,74,B
2012,3623,Female,Perlis,13,3,10,2,28,28,56,C
2013,3624,Male,Terengganu,21,8,9,1,39,29,68,B
2018,3625,Female,Malacca,17,5,6,5,33,40,73,B
2013,3626,Female,Perak,19,7,8,2,36,27,63,B
2016,3627,Male,Sarawak,20,8,6,5,39,25,64,B
2016,3628,Female,Terengganu,21,6,6,1,34,34,68,B
2019,3629,Male,Pahang,15,4,3,5,27,39,66,B
2017,3630,Female,Pahang,17,9,6,1,33,26,59,C
2012,3631,Female,Kedah,15,4,4,5,28,34,62,B
2016,3632,Female,Kelantan,13,7,9,3,32,34,66,B
2015,3633,Female,Malacca,15,8,10,2,35,24,59,C
2012,3634,Male,Johor,21,6,4,4,35,23,58,C
2014,3635,Male,Negeri Sembilan,13,9,6,4,32,38,70,B
2015,3636,Male,Perlis,20,7,3,5,35,29,64,B
2012,3637,Female,Terengganu,15,9,3,1,28,36,64,B
2015,3638,Female,Perlis,21,10,6,5,42,37,79,A
2012,3639,Female,Malacca,18,7,9,4,38,28,66,B
2014,3640,Male,Sarawak,17,3,9,5,34,32,66,B
2019,3641,Female,Negeri Sembilan,14,6,5,2,27,33,60,B
2013,3642,Female,Selangor,21,6,5,3,35,25,60,B
2019,3643,Male,Malacca,21,6,3,4,34,37,71,B
2013,3644,Female,Perlis,18,8,6,4,36,30,66,B
2018,3645,Female,Terengganu,21,10,7,4,42,39,81,A
2012,3646,Male,Sarawak,20,5,3,5,33,23,56,C
2014,3647,Male,Penang,21,3,6,2,32,32,64,B
2016,3648,Female,Pahang,14,8,4,2,28,22,50,C
2015,3649,Male,Pahang,21,4,9,4,38,29,67,B
2018,3650,Female,Kelantan,13,4,10,1,28,22,50,C
2014,3651,Female,Sarawak,17,10,10,2,39,31,70,B
2015,3652,Female,Pahang,13,3,3,1,20,22,42,F
2019,3653,Female,Kedah,21,7,5,2,35,40,75,B
2012,3654,Female,Pahang,14,9,3,1,27,35,62,B
2012,3655,Female,Kedah,14,10,9,2,35,38,73,B
2018,3656,Female,Johor,15,9,5,5,34,37,71,B
2019,3657,Female,Johor,20,8,3,1,32,30,62,B
2019,3658,Male,Kelantan,14,10,7,5,36,30,66,B
2013,3659,Female,Sarawak,18,3,6,4,31,22,53,C
2013,3660,Female,Penang,13,6,4,3,26,29,55,C
2014,3661,Male,Johor,13,9,4,4,30,26,56,C
2018,3662,Female,Kelantan,20,3,6,1,30,30,60,B
2012,3663,Female,Pahang,15,8,7,4,34,28,62,B
2012,3664,Male,Kelantan,18,8,3,1,30,37,67,B
2019,3665,Female,Malacca,19,7,3,5,34,38,72,B
2015,3666,Male,Perak,13,5,8,4,30,28,58,C
2016,3667,Female,Pahang,14,10,5,5,34,24,58,C
2018,3668,Female,Malacca,19,5,6,5,35,28,63,B
2016,3669,Female,Sarawak,21,10,4,2,37,38,75,B
2013,3670,Male,Sarawak,18,4,9,3,34,40,74,B
2013,3671,Male,Terengganu,14,7,5,1,27,24,51,C
2018,3672,Male,Penang,13,8,10,2,33,39,72,B
2013,3673,Female,Kelantan,13,3,5,3,24,35,59,C
2017,3674,Female,Penang,20,8,3,5,36,33,69,B
2013,3675,Male,Selangor,13,6,8,3,30,32,62,B
2015,3676,Male,Pahang,14,9,5,4,32,31,63,B
2018,3677,Female,Negeri Sembilan,21,4,5,5,35,39,74,B
2018,3678,Female,Penang,20,9,5,1,35,23,58,C
2015,3679,Female,Perak,15,3,10,4,32,25,57,C
2017,3680,Male,Selangor,20,8,7,4,39,40,79,A
2019,3681,Male,Sabah,14,3,7,2,26,40,66,B
2019,3682,Female,Penang,14,6,4,2,26,31,57,C
2012,3683,Female,Negeri Sembilan,19,3,3,2,27,32,59,C
2017,3684,Male,Sarawak,17,7,6,3,33,38,71,B
2018,3685,Male,Kedah,18,7,5,4,34,28,62,B
2017,3686,Male,Kelantan,19,7,4,5,35,34,69,B
2013,3687,Male,Perlis,17,5,8,4,34,39,73,B
2017,3688,Male,Perlis,21,9,10,5,45,40,85,A
2015,3689,Female,Negeri Sembilan,14,6,8,3,31,31,62,B
2019,3690,Male,Sabah,18,10,4,4,36,32,68,B
2016,3691,Female,Perlis,20,8,10,5,43,35,78,B
2012,3692,Female,Kedah,19,5,6,5,35,33,68,B
2019,3693,Male,Sarawak,17,7,9,1,34,32,66,B
2013,3694,Female,Selangor,15,8,9,3,35,23,58,C
2014,3695,Female,Selangor,21,6,7,4,38,37,75,B
2018,3696,Female,Perlis,15,5,6,2,28,23,51,C
2013,3697,Male,Pahang,19,8,5,2,34,23,57,C
2014,3698,Female,Pahang,19,9,6,3,37,38,75,B
2012,3699,Male,Kedah,14,10,3,2,29,40,69,B
2013,3700,Male,Perak,16,8,7,2,33,37,70,B
2015,3701,Female,Sarawak,16,3,9,5,33,26,59,C
2016,3702,Female,Sarawak,20,7,9,1,37,32,69,B
2019,3703,Male,Sabah,15,5,10,2,32,35,67,B
2014,3704,Male,Malacca,20,4,8,3,35,28,63,B
2012,3705,Female,Selangor,16,9,7,5,37,36,73,B
2013,3706,Male,Sarawak,18,7,9,2,36,37,73,B
2015,3707,Male,Selangor,18,6,7,1,32,30,62,B
2013,3708,Female,Perlis,19,8,6,4,37,30,67,B
2012,3709,Male,Kelantan,16,4,9,1,30,26,56,C
2014,3710,Female,Penang,21,8,3,2,34,35,69,B
2016,3711,Female,Selangor,16,5,9,3,33,36,69,B
2012,3712,Male,Kedah,13,10,8,4,35,25,60,B
2016,3713,Female,Sabah,13,9,6,3,31,27,58,C
2013,3714,Female,Pahang,14,4,10,1,29,34,63,B
2019,3715,Male,Malacca,14,10,9,4,37,29,66,B
2015,3716,Female,Sabah,17,10,4,5,36,40,76,B
2014,3717,Female,Malacca,17,7,8,5,37,30,67,B
2016,3718,Male,Terengganu,21,3,4,1,29,37,66,B
2015,3719,Female,Kelantan,20,4,7,5,36,35,71,B
2014,3720,Female,Pahang,18,6,10,1,35,39,74,B
2015,3721,Female,Pahang,18,5,6,1,30,33,63,B
2018,3722,Male,Kelantan,16,3,5,1,25,39,64,B
2012,3723,Female,Penang,20,5,6,5,36,24,60,B
2015,3724,Male,Malacca,13,8,5,2,28,31,59,C
2014,3725,Male,Kedah,21,10,10,4,45,34,79,A
2016,3726,Male,Malacca,14,9,8,4,35,36,71,B
2013,3727,Male,Negeri Sembilan,21,3,10,1,35,25,60,B
2012,3728,Female,Negeri Sembilan,19,7,6,3,35,29,64,B
2016,3729,Male,Sarawak,17,7,3,1,28,35,63,B
2017,3730,Female,Selangor,14,6,5,4,29,37,66,B
2012,3731,Male,Malacca,13,9,7,3,32,22,54,C
2012,3732,Male,Terengganu,14,4,6,2,26,36,62,B
2019,3733,Female,Sabah,18,7,8,5,38,29,67,B
2015,3734,Female,Johor,18,7,7,5,37,29,66,B
2014,3735,Male,Negeri Sembilan,19,9,5,3,36,39,75,B
2017,3736,Female,Sarawak,16,5,5,5,31,24,55,C
2017,3737,Female,Johor,13,8,7,3,31,37,68,B
2012,3738,Female,Malacca,17,10,5,4,36,22,58,C
2017,3739,Female,Sabah,17,6,7,4,34,26,60,B
2012,3740,Female,Perak,19,7,8,2,36,33,69,B
2014,3741,Female,Terengganu,19,9,5,1,34,39,73,B
2014,3742,Female,Sarawak,19,6,5,4,34,27,61,B
2016,3743,Male,Sabah,17,9,3,2,31,37,68,B
2014,3744,Female,Sabah,18,8,5,5,36,33,69,B
2012,3745,Female,Malacca,15,5,6,3,29,23,52,C
2014,3746,Female,Sarawak,13,10,7,3,33,36,69,B
2018,3747,Female,Sabah,16,7,5,5,33,30,63,B
2019,3748,Female,Perak,20,7,8,1,36,34,70,B
2019,3749,Male,Perlis,18,10,9,2,39,34,73,B
2017,3750,Female,Perak,14,5,3,3,25,25,50,C
2018,3751,Male,Terengganu,13,5,5,2,25,36,61,B
2018,3752,Female,Sabah,14,8,10,3,35,24,59,C
2013,3753,Female,Pahang,14,9,4,1,28,39,67,B
2014,3754,Female,Pahang,21,10,8,2,41,33,74,B
2018,3755,Female,Pahang,14,3,8,2,27,26,53,C
2014,3756,Female,Johor,14,9,9,3,35,39,74,B
2012,3757,Male,Pahang,15,6,7,4,32,27,59,C
2017,3758,Male,Sabah,15,6,4,2,27,33,60,B
2014,3759,Female,Sarawak,14,6,8,1,29,38,67,B
2016,3760,Female,Negeri Sembilan,20,3,9,5,37,40,77,B
2019,3761,Male,Sabah,14,4,9,5,32,38,70,B
2014,3762,Female,Pahang,16,6,3,1,26,22,48,F
2016,3763,Male,Malacca,16,9,5,5,35,32,67,B
2012,3764,Female,Sabah,15,3,7,2,27,34,61,B
2014,3765,Female,Kelantan,17,4,3,4,28,40,68,B
2015,3766,Female,Sabah,15,9,4,5,33,30,63,B
2018,3767,Male,Sabah,17,4,7,3,31,30,61,B
2018,3768,Male,Terengganu,17,10,4,2,33,26,59,C
2019,3769,Male,Kedah,16,7,3,5,31,25,56,C
2016,3770,Female,Negeri Sembilan,13,4,7,3,27,24,51,C
2016,3771,Female,Kedah,21,5,8,2,36,30,66,B
2016,3772,Female,Johor,14,5,10,5,34,24,58,C
2013,3773,Female,Perlis,17,10,6,3,36,28,64,B
2012,3774,Male,Perlis,21,5,3,2,31,35,66,B
2018,3775,Male,Kelantan,14,4,6,2,26,31,57,C
2019,3776,Female,Sarawak,13,10,3,2,28,35,63,B
2013,3777,Male,Perak,14,4,4,3,25,22,47,F
2016,3778,Male,Kelantan,21,10,3,5,39,33,72,B
2014,3779,Male,Terengganu,16,9,3,5,33,31,64,B
2013,3780,Male,Kelantan,19,6,8,3,36,32,68,B
2012,3781,Male,Selangor,20,9,5,3,37,30,67,B
2012,3782,Female,Perak,19,9,5,2,35,24,59,C
2014,3783,Male,Johor,21,7,9,1,38,25,63,B
2012,3784,Male,Pahang,20,3,9,5,37,39,76,B
2014,3785,Male,Sabah,20,9,6,4,39,22,61,B
2017,3786,Male,Kedah,13,7,4,4,28,24,52,C
2016,3787,Female,Johor,14,6,6,3,29,38,67,B
2014,3788,Male,Selangor,19,5,4,5,33,25,58,C
2017,3789,Male,Malacca,13,9,10,5,37,35,72,B
2012,3790,Male,Negeri Sembilan,15,5,8,5,33,28,61,B
2012,3791,Male,Perak,19,6,8,3,36,24,60,B
2017,3792,Male,Johor,14,10,5,2,31,23,54,C
2018,3793,Male,Sarawak,18,5,7,2,32,30,62,B
2015,3794,Male,Sarawak,18,6,8,3,35,24,59,C
2012,3795,Female,Perlis,17,8,8,3,36,39,75,B
2014,3796,Male,Penang,16,9,5,2,32,23,55,C
2016,3797,Male,Perlis,14,9,3,4,30,37,67,B
2015,3798,Male,Pahang,19,6,10,2,37,25,62,B
2018,3799,Male,Johor,21,5,3,3,32,25,57,C
2013,3800,Female,Terengganu,18,4,4,4,30,24,54,C
2013,3801,Male,Negeri Sembilan,15,7,8,4,34,32,66,B
2012,3802,Female,Pahang,20,9,10,3,42,38,80,A
2019,3803,Male,Johor,18,4,8,3,33,33,66,B
2014,3804,Male,Sarawak,19,6,7,1,33,38,71,B
2012,3805,Female,Perak,14,4,8,1,27,23,50,C
2013,3806,Female,Sarawak,15,6,9,4,34,24,58,C
2018,3807,Male,Johor,21,5,6,3,35,26,61,B
2017,3808,Female,Perlis,15,9,4,3,31,34,65,B
2017,3809,Female,Kedah,15,7,7,4,33,38,71,B
2016,3810,Male,Perlis,18,5,5,4,32,26,58,C
2013,3811,Male,Kedah,19,9,10,3,41,22,63,B
2016,3812,Male,Kedah,18,6,6,4,34,40,74,B
2014,3813,Female,Johor,18,7,3,1,29,32,61,B
2014,3814,Female,Malacca,16,6,10,3,35,24,59,C
2013,3815,Male,Penang,16,4,8,2,30,39,69,B
2018,3816,Male,Perlis,17,7,5,3,32,30,62,B
2015,3817,Male,Negeri Sembilan,20,8,9,5,42,30,72,B
2017,3818,Female,Sarawak,13,5,7,3,28,31,59,C
2019,3819,Male,Malacca,15,8,8,3,34,22,56,C
2018,3820,Female,Malacca,14,5,6,5,30,30,60,B
2019,3821,Female,Sarawak,18,10,7,4,39,39,78,B
2018,3822,Male,Terengganu,19,4,9,5,37,30,67,B
2015,3823,Male,Kelantan,14,9,9,5,37,38,75,B
2017,3824,Female,Terengganu,21,10,4,1,36,28,64,B
2016,3825,Female,Terengganu,13,7,3,1,24,38,62,B
2017,3826,Female,Perak,13,8,7,5,33,35,68,B
2019,3827,Female,Kedah,13,10,9,2,34,30,64,B
2012,3828,Female,Selangor,21,10,8,2,41,31,72,B
2013,3829,Male,Terengganu,18,6,7,5,36,30,66,B
2016,3830,Male,Perlis,20,9,8,5,42,34,76,B
2017,3831,Male,Malacca,20,7,3,2,32,25,57,C
2013,3832,Male,Perak,21,3,6,3,33,36,69,B
2012,3833,Male,Pahang,13,6,4,3,26,31,57,C
2015,3834,Male,Johor,13,10,6,1,30,33,63,B
2012,3835,Male,Kelantan,15,8,8,4,35,33,68,B
2013,3836,Female,Selangor,13,3,3,4,23,29,52,C
2013,3837,Female,Malacca,20,3,6,3,32,37,69,B
2014,3838,Male,Kelantan,21,8,3,2,34,26,60,B
2013,3839,Female,Perak,20,5,7,1,33,24,57,C
2012,3840,Female,Kelantan,17,3,8,2,30,31,61,B
2017,3841,Male,Malacca,13,8,10,2,33,36,69,B
2019,3842,Female,Malacca,18,7,4,1,30,37,67,B
2015,3843,Male,Selangor,17,7,7,5,36,26,62,B
2016,3844,Female,Terengganu,15,5,10,3,33,26,59,C
2018,3845,Female,Malacca,17,10,10,2,39,28,67,B
2016,3846,Female,Pahang,19,4,9,5,37,35,72,B
2018,3847,Male,Perlis,18,6,4,2,30,25,55,C
2016,3848,Male,Perlis,17,8,9,2,36,40,76,B
2018,3849,Male,Perlis,20,5,7,2,34,39,73,B
2014,3850,Female,Negeri Sembilan,17,10,7,1,35,29,64,B
2012,3851,Male,Negeri Sembilan,17,5,9,1,32,32,64,B
2017,3852,Male,Kelantan,19,10,8,4,41,37,78,B
2017,3853,Male,Perlis,20,10,10,5,45,39,84,A
2015,3854,Female,Johor,20,6,4,1,31,37,68,B
2016,3855,Male,Malacca,16,3,7,2,28,23,51,C
2013,3856,Male,Penang,13,8,6,4,31,30,61,B
2014,3857,Female,Sarawak,21,9,8,2,40,24,64,B
2013,3858,Female,Kedah,14,8,7,3,32,38,70,B
2019,3859,Female,Sabah,19,3,8,2,32,34,66,B
2013,3860,Female,Perak,17,6,7,5,35,30,65,B
2018,3861,Male,Sarawak,18,8,6,1,33,31,64,B
2012,3862,Female,Sarawak,13,9,9,4,35,37,72,B
2019,3863,Female,Johor,15,3,10,1,29,37,66,B
2015,3864,Female,Sarawak,17,5,7,4,33,39,72,B
2015,3865,Male,Perak,16,4,9,2,31,29,60,B
2019,3866,Female,Sarawak,18,5,5,3,31,31,62,B
2016,3867,Male,Johor,14,4,10,1,29,22,51,C
2019,3868,Female,Selangor,20,5,5,3,33,28,61,B
2016,3869,Male,Penang,20,3,4,1,28,24,52,C
2018,3870,Female,Perlis,15,4,8,4,31,33,64,B
2016,3871,Male,Sarawak,15,3,8,1,27,32,59,C
2012,3872,Male,Malacca,18,5,6,5,34,40,74,B
2012,3873,Male,Kelantan,13,7,3,4,27,36,63,B
2017,3874,Male,Sabah,16,3,6,3,28,30,58,C
2019,3875,Female,Selangor,19,9,4,2,34,31,65,B
2016,3876,Female,Kedah,19,5,9,2,35,40,75,B
2017,3877,Female,Perlis,19,3,4,1,27,29,56,C
2018,3878,Female,Malacca,21,3,6,1,31,26,57,C
2019,3879,Male,Sabah,20,10,8,5,43,25,68,B
2018,3880,Male,Sabah,15,3,9,2,29,30,59,C
2012,3881,Male,Sabah,16,4,9,4,33,28,61,B
2014,3882,Female,Johor,14,8,3,4,29,40,69,B
2012,3883,Female,Sabah,18,7,5,1,31,39,70,B
2014,3884,Female,Negeri Sembilan,16,6,6,5,33,38,71,B
2018,3885,Female,Kedah,16,8,6,2,32,26,58,C
2018,3886,Male,Sarawak,14,10,10,2,36,38,74,B
2016,3887,Female,Negeri Sembilan,16,5,3,1,25,30,55,C
2018,3888,Male,Terengganu,17,8,4,2,31,29,60,B
2016,3889,Male,Sarawak,20,5,4,4,33,36,69,B
2015,3890,Male,Johor,17,7,9,2,35,37,72,B
2016,3891,Male,Perlis,17,5,4,1,27,34,61,B
2019,3892,Female,Sarawak,16,8,3,1,28,27,55,C
2015,3893,Male,Penang,20,3,5,5,33,34,67,B
2012,3894,Female,Perlis,17,8,3,3,31,23,54,C
2014,3895,Female,Sarawak,19,8,8,5,40,22,62,B
2015,3896,Male,Kedah,14,5,7,4,30,27,57,C
2018,3897,Female,Sabah,15,8,4,1,28,22,50,C
2017,3898,Male,Penang,14,4,8,4,30,35,65,B
2013,3899,Female,Selangor,17,5,9,2,33,35,68,B
2016,3900,Female,Johor,13,4,4,2,23,33,56,C
2015,3901,Female,Johor,21,10,6,4,41,25,66,B
2012,3902,Female,Perak,13,6,9,5,33,36,69,B
2012,3903,Female,Selangor,13,5,9,1,28,37,65,B
2012,3904,Male,Malacca,14,10,5,5,34,30,64,B
2016,3905,Male,Penang,14,10,5,1,30,30,60,B
2012,3906,Male,Negeri Sembilan,16,9,4,3,32,31,63,B
2013,3907,Female,Sabah,18,6,6,3,33,22,55,C
2018,3908,Male,Negeri Sembilan,14,3,5,4,26,31,57,C
2014,3909,Male,Johor,20,4,5,4,33,33,66,B
2018,3910,Male,Kedah,15,9,8,4,36,27,63,B
2017,3911,Male,Sabah,14,9,4,5,32,37,69,B
2018,3912,Female,Selangor,16,9,6,1,32,28,60,B
2016,3913,Female,Sarawak,20,9,4,1,34,30,64,B
2014,3914,Female,Perak,19,4,4,5,32,27,59,C
2019,3915,Male,Terengganu,15,5,4,4,28,31,59,C
2014,3916,Male,Pahang,17,9,6,3,35,30,65,B
2015,3917,Male,Terengganu,21,4,5,5,35,27,62,B
2019,3918,Female,Sabah,17,9,8,5,39,23,62,B
2018,3919,Female,Pahang,18,6,3,5,32,23,55,C
2013,3920,Male,Terengganu,19,7,8,5,39,28,67,B
2017,3921,Male,Sabah,16,7,4,4,31,38,69,B
2013,3922,Female,Selangor,17,8,10,1,36,22,58,C
2016,3923,Male,Sabah,19,9,10,1,39,23,62,B
2019,3924,Female,Malacca,20,9,5,2,36,27,63,B
2014,3925,Female,Negeri Sembilan,13,7,4,2,26,28,54,C
2018,3926,Female,Malacca,15,8,5,3,31,30,61,B
2013,3927,Female,Sarawak,20,4,8,3,35,24,59,C
2017,3928,Female,Perak,20,10,9,4,43,36,79,A
2017,3929,Female,Negeri Sembilan,16,10,4,1,31,28,59,C
2017,3930,Male,Selangor,19,3,5,3,30,37,67,B
2012,3931,Male,Kelantan,15,4,9,5,33,28,61,B
2015,3932,Female,Pahang,14,3,10,1,28,27,55,C
2014,3933,Female,Malacca,16,8,10,5,39,30,69,B
2017,3934,Female,Terengganu,14,9,7,2,32,30,62,B
2015,3935,Male,Sabah,21,3,9,4,37,34,71,B
2013,3936,Male,Johor,20,7,6,5,38,24,62,B
2016,3937,Female,Perak,17,8,4,4,33,32,65,B
2018,3938,Male,Pahang,17,7,3,3,30,38,68,B
2012,3939,Female,Kelantan,14,3,3,2,22,40,62,B
2018,3940,Male,Terengganu,21,8,4,1,34,36,70,B
2018,3941,Male,Perlis,14,8,10,3,35,34,69,B
2014,3942,Female,Malacca,18,3,10,4,35,31,66,B
2016,3943,Female,Kelantan,20,8,5,2,35,31,66,B
2018,3944,Male,Negeri Sembilan,19,7,9,2,37,33,70,B
2019,3945,Male,Malacca,13,8,3,4,28,22,50,C
2012,3946,Female,Perlis,15,10,4,4,33,34,67,B
2017,3947,Male,Pahang,13,3,4,1,21,34,55,C
2013,3948,Female,Sarawak,18,3,3,1,25,31,56,C
2017,3949,Female,Kedah,17,4,9,3,33,40,73,B
2017,3950,Male,Sabah,17,3,8,5,33,39,72,B
2018,3951,Male,Perak,13,4,5,2,24,35,59,C
2014,3952,Female,Selangor,20,5,3,5,33,40,73,B
2018,3953,Male,Selangor,13,9,4,3,29,35,64,B
2013,3954,Female,Sarawak,18,4,8,4,34,27,61,B
2017,3955,Male,Pahang,14,7,9,3,33,36,69,B
2017,3956,Male,Johor,19,6,4,3,32,32,64,B
2018,3957,Female,Johor,20,5,10,4,39,24,63,B
2015,3958,Female,Johor,15,5,10,2,32,23,55,C
2016,3959,Female,Kelantan,20,6,3,5,34,39,73,B
2017,3960,Male,Selangor,19,10,4,5,38,24,62,B
2017,3961,Female,Selangor,14,4,6,3,27,32,59,C
2019,3962,Male,Negeri Sembilan,16,7,9,1,33,37,70,B
2018,3963,Male,Perlis,14,10,6,2,32,25,57,C
2017,3964,Male,Pahang,21,4,6,5,36,30,66,B
2017,3965,Male,Sabah,19,8,9,5,41,35,76,B
2016,3966,Male,Sarawak,20,7,10,2,39,22,61,B
2016,3967,Male,Negeri Sembilan,19,4,7,2,32,22,54,C
2019,3968,Female,Sarawak,15,10,6,2,33,29,62,B
2015,3969,Female,Perak,20,6,10,4,40,25,65,B
2016,3970,Male,Selangor,14,5,6,1,26,24,50,C
2014,3971,Male,Kedah,15,6,4,1,26,35,61,B
2014,3972,Male,Johor,21,10,4,5,40,27,67,B
2017,3973,Male,Kelantan,14,3,7,5,29,28,57,C
2013,3974,Male,Malacca,19,6,5,2,32,33,65,B
2013,3975,Female,Kelantan,15,10,10,2,37,23,60,B
2017,3976,Female,Negeri Sembilan,21,3,3,3,30,39,69,B
2018,3977,Male,Malacca,15,8,9,2,34,36,70,B
2017,3978,Male,Malacca,15,6,5,2,28,25,53,C
2018,3979,Male,Selangor,21,9,9,4,43,26,69,B
2015,3980,Female,Johor,20,10,10,2,42,22,64,B
2018,3981,Male,Perak,13,9,5,4,31,28,59,C
2015,3982,Male,Perak,20,5,6,2,33,30,63,B
2016,3983,Male,Johor,14,6,6,2,28,30,58,C
2018,3984,Female,Johor,17,7,3,2,29,26,55,C
2018,3985,Female,Johor,13,9,7,1,30,27,57,C
2016,3986,Male,Terengganu,19,9,6,3,37,30,67,B
2014,3987,Female,Sabah,18,4,3,3,28,34,62,B
2014,3988,Female,Perlis,15,7,9,4,35,35,70,B
2016,3989,Male,Sabah,16,9,6,2,33,22,55,C
2019,3990,Male,Negeri Sembilan,19,3,3,5,30,35,65,B
2017,3991,Male,Malacca,14,6,3,3,26,29,55,C
2012,3992,Male,Terengganu,14,10,9,3,36,37,73,B
2013,3993,Female,Perak,21,3,8,2,34,35,69,B
2019,3994,Female,Penang,20,3,8,5,36,28,64,B
2019,3995,Female,Kelantan,17,8,5,1,31,31,62,B
2012,3996,Male,Johor,15,4,9,5,33,32,65,B
2014,3997,Male,Malacca,19,6,9,5,39,26,65,B
2014,3998,Male,Pahang,13,8,5,1,27,38,65,B
2014,3999,Female,Terengganu,16,9,5,3,33,36,69,B
2012,4000,Female,Perak,14,6,3,4,27,37,64,B
2013,4001,Male,Negeri Sembilan,13,10,7,2,32,24,56,C
2014,4002,Female,Malacca,17,3,10,1,31,33,64,B
2016,4003,Female,Pahang,19,6,4,5,34,40,74,B
2015,4004,Female,Johor,15,10,3,2,30,28,58,C
2018,4005,Female,Kedah,15,9,10,2,36,23,59,C
2018,4006,Female,Sabah,19,7,6,1,33,25,58,C
2012,4007,Male,Terengganu,16,10,9,1,36,33,69,B
2017,4008,Male,Kelantan,19,8,3,5,35,22,57,C
2019,4009,Female,Selangor,16,5,5,1,27,33,60,B
2016,4010,Female,Penang,20,10,7,1,38,31,69,B
2018,4011,Female,Pahang,21,7,10,1,39,33,72,B
2014,4012,Female,Sabah,18,8,3,2,31,38,69,B
2018,4013,Female,Kelantan,13,7,6,5,31,30,61,B
2014,4014,Male,Selangor,15,3,5,4,27,40,67,B
2016,4015,Male,Perlis,17,8,3,5,33,33,66,B
2019,4016,Female,Sarawak,15,3,5,1,24,30,54,C
2014,4017,Female,Pahang,20,8,3,4,35,23,58,C
2014,4018,Female,Negeri Sembilan,14,6,7,3,30,33,63,B
2016,4019,Male,Negeri Sembilan,20,5,4,1,30,22,52,C
2016,4020,Male,Perlis,16,6,6,5,33,22,55,C
2019,4021,Female,Malacca,15,3,4,4,26,38,64,B
2015,4022,Male,Penang,21,5,5,5,36,26,62,B
2016,4023,Male,Kelantan,14,8,8,3,33,35,68,B
2019,4024,Male,Johor,13,6,10,1,30,34,64,B
2012,4025,Male,Penang,18,9,6,3,36,24,60,B
2018,4026,Female,Sabah,16,3,6,2,27,39,66,B
2018,4027,Female,Perlis,19,9,3,3,34,23,57,C
2017,4028,Female,Kelantan,16,3,3,4,26,32,58,C
2013,4029,Female,Kedah,18,5,3,3,29,26,55,C
2016,4030,Male,Negeri Sembilan,18,8,10,5,41,36,77,B
2018,4031,Male,Malacca,15,9,10,2,36,31,67,B
2018,4032,Male,Kelantan,16,3,6,5,30,30,60,B
2014,4033,Male,Penang,16,8,10,1,35,34,69,B
2019,4034,Male,Perak,14,10,4,4,32,34,66,B
2014,4035,Female,Perak,21,8,7,1,37,40,77,B
2013,4036,Female,Sabah,14,6,6,3,29,30,59,C
2014,4037,Male,Johor,19,8,5,2,34,30,64,B
2017,4038,Male,Malacca,15,3,9,5,32,37,69,B
2019,4039,Male,Penang,16,5,10,2,33,40,73,B
2014,4040,Male,Perlis,15,8,10,5,38,29,67,B
2013,4041,Male,Negeri Sembilan,13,5,5,5,28,22,50,C
2016,4042,Female,Pahang,14,8,5,1,28,39,67,B
2014,4043,Male,Johor,16,5,10,1,32,30,62,B
2013,4044,Male,Terengganu,17,6,4,2,29,22,51,C
2017,4045,Male,Malacca,20,3,8,4,35,37,72,B
2014,4046,Female,Kedah,16,9,5,4,34,27,61,B
2015,4047,Male,Perlis,14,6,10,5,35,40,75,B
2013,4048,Male,Negeri Sembilan,19,6,7,5,37,29,66,B
2017,4049,Male,Kedah,15,5,8,1,29,29,58,C
2013,4050,Male,Terengganu,13,4,4,2,23,36,59,C
2016,4051,Male,Kedah,17,7,6,5,35,39,74,B
2014,4052,Male,Sarawak,17,7,9,2,35,29,64,B
2019,4053,Female,Sarawak,18,5,6,5,34,36,70,B
2015,4054,Male,Kelantan,15,7,6,4,32,27,59,C
2012,4055,Female,Terengganu,14,10,6,5,35,23,58,C
2018,4056,Female,Johor,19,3,5,5,32,36,68,B
2019,4057,Female,Kelantan,14,3,9,4,30,38,68,B
2015,4058,Male,Perlis,14,7,5,3,29,36,65,B
2015,4059,Female,Kedah,19,9,10,1,39,39,78,B
2013,4060,Female,Kedah,19,8,8,1,36,26,62,B
2017,4061,Female,Penang,13,9,7,3,32,24,56,C
2012,4062,Female,Johor,13,9,7,4,33,39,72,B
2013,4063,Male,Selangor,19,6,10,2,37,40,77,B
2012,4064,Female,Penang,19,5,5,2,31,27,58,C
2018,4065,Male,Kelantan,16,5,7,5,33,29,62,B
2013,4066,Male,Sarawak,16,5,6,3,30,22,52,C
2015,4067,Male,Johor,14,4,8,2,28,36,64,B
2013,4068,Female,Pahang,19,10,9,2,40,39,79,A
2019,4069,Female,Perlis,14,9,6,3,32,28,60,B
2016,4070,Male,Sabah,17,5,3,2,27,27,54,C
2013,4071,Female,Kedah,19,6,5,3,33,37,70,B
2016,4072,Female,Kedah,18,10,7,5,40,37,77,B
2013,4073,Male,Perlis,19,6,10,5,40,40,80,A
2019,4074,Female,Malacca,14,7,6,1,28,33,61,B
2014,4075,Female,Johor,15,9,4,4,32,36,68,B
2018,4076,Male,Sarawak,16,9,9,1,35,28,63,B
2019,4077,Male,Pahang,18,5,4,2,29,37,66,B
2016,4078,Female,Perak,18,9,10,4,41,36,77,B
2013,4079,Female,Kedah,14,6,8,2,30,31,61,B
2017,4080,Male,Sarawak,20,5,8,1,34,34,68,B
2012,4081,Male,Johor,21,4,8,2,35,33,68,B
2013,4082,Male,Malacca,15,7,10,5,37,27,64,B
2017,4083,Female,Pahang,20,3,7,1,31,34,65,B
2012,4084,Female,Sarawak,19,5,8,5,37,37,74,B
2016,4085,Male,Johor,21,9,6,5,41,28,69,B
2015,4086,Female,Johor,15,7,4,5,31,32,63,B
2016,4087,Female,Johor,19,7,5,3,34,39,73,B
2016,4088,Female,Malacca,19,3,7,4,33,34,67,B
2019,4089,Female,Kelantan,17,3,6,5,31,28,59,C
2014,4090,Male,Sabah,21,10,3,5,39,32,71,B
2017,4091,Female,Selangor,20,8,3,3,34,36,70,B
2015,4092,Male,Kelantan,21,6,4,5,36,35,71,B
2015,4093,Female,Sabah,16,8,7,2,33,30,63,B
2015,4094,Female,Johor,21,8,6,4,39,37,76,B
2019,4095,Male,Sabah,16,9,7,1,33,31,64,B
2014,4096,Male,Penang,21,7,10,1,39,39,78,B
2012,4097,Female,Kelantan,18,6,3,4,31,32,63,B
2018,4098,Male,Kedah,21,7,4,1,33,37,70,B
2019,4099,Female,Selangor,21,7,7,4,39,36,75,B
2014,4100,Female,Kelantan,18,10,9,3,40,22,62,B
2013,4101,Male,Kedah,16,3,5,1,25,37,62,B
2018,4102,Female,Kedah,15,5,4,3,27,28,55,C
2017,4103,Female,Malacca,20,7,4,3,34,31,65,B
2015,4104,Female,Kelantan,15,7,3,5,30,28,58,C
2013,4105,Male,Sabah,19,7,3,2,31,34,65,B
2014,4106,Male,Penang,15,9,6,5,35,27,62,B
2013,4107,Female,Kelantan,14,9,10,3,36,36,72,B
2014,4108,Female,Pahang,21,10,6,2,39,36,75,B
2013,4109,Male,Johor,21,6,3,3,33,24,57,C
2013,4110,Male,Perak,18,7,4,4,33,33,66,B
2019,4111,Male,Sarawak,17,10,9,4,40,38,78,B
2014,4112,Male,Kelantan,15,9,7,5,36,29,65,B
2013,4113,Male,Kedah,13,6,9,2,30,38,68,B
2014,4114,Male,Kedah,17,4,5,3,29,31,60,B
2013,4115,Female,Selangor,16,3,7,1,27,32,59,C
2016,4116,Male,Johor,18,3,8,2,31,28,59,C
2015,4117,Female,Terengganu,21,8,5,2,36,33,69,B
2014,4118,Male,Perak,18,8,7,5,38,22,60,B
2019,4119,Male,Sarawak,17,7,6,4,34,25,59,C
2015,4120,Male,Selangor,17,8,10,5,40,34,74,B
2018,4121,Male,Malacca,13,3,7,3,26,22,48,F
2014,4122,Male,Kedah,19,4,10,4,37,31,68,B
2015,4123,Female,Kelantan,13,6,5,3,27,27,54,C
2019,4124,Male,Kedah,15,7,7,3,32,34,66,B
2018,4125,Male,Kelantan,18,4,4,4,30,31,61,B
2013,4126,Female,Kelantan,18,3,9,4,34,34,68,B
2015,4127,Female,Malacca,15,3,7,3,28,39,67,B
2019,4128,Male,Sabah,20,3,9,1,33,23,56,C
2019,4129,Female,Kedah,14,10,10,1,35,25,60,B
2018,4130,Female,Selangor,14,8,7,1,30,25,55,C
2015,4131,Female,Malacca,17,8,9,3,37,37,74,B
2018,4132,Female,Terengganu,19,6,5,5,35,38,73,B
2012,4133,Male,Pahang,13,4,6,5,28,22,50,C
2016,4134,Male,Terengganu,14,5,3,2,24,29,53,C
2016,4135,Female,Johor,17,10,6,5,38,40,78,B
2016,4136,Male,Selangor,15,3,5,3,26,39,65,B
2013,4137,Female,Penang,19,6,3,4,32,38,70,B
2018,4138,Female,Selangor,18,10,8,2,38,24,62,B
2014,4139,Female,Perlis,19,4,6,3,32,27,59,C
2012,4140,Female,Johor,14,7,3,3,27,24,51,C
2016,4141,Female,Penang,21,5,5,5,36,31,67,B
2014,4142,Male,Johor,21,6,9,1,37,31,68,B
2013,4143,Male,Selangor,15,7,9,2,33,31,64,B
2015,4144,Male,Johor,16,4,7,2,29,37,66,B
2015,4145,Male,Negeri Sembilan,16,5,5,5,31,36,67,B
2019,4146,Male,Kelantan,13,5,8,1,27,27,54,C
2013,4147,Female,Selangor,15,8,9,1,33,24,57,C
2015,4148,Male,Perlis,18,4,6,2,30,32,62,B
2014,4149,Female,Kelantan,18,6,6,4,34,23,57,C
2015,4150,Male,Perlis,13,7,6,3,29,25,54,C
2013,4151,Female,Kelantan,14,8,5,5,32,39,71,B
2019,4152,Male,Sarawak,21,10,8,1,40,23,63,B
2018,4153,Male,Pahang,19,5,7,5,36,33,69,B
2017,4154,Male,Pahang,19,10,8,3,40,36,76,B
2016,4155,Female,Pahang,13,9,6,1,29,26,55,C
2012,4156,Male,Perlis,14,7,5,2,28,28,56,C
2015,4157,Male,Malacca,16,6,10,5,37,37,74,B
2014,4158,Male,Kelantan,19,5,8,5,37,30,67,B
2012,4159,Male,Malacca,14,6,8,2,30,22,52,C
2014,4160,Male,Penang,13,7,10,1,31,37,68,B
2014,4161,Male,Penang,20,9,6,4,39,35,74,B
2018,4162,Female,Terengganu,17,8,8,5,38,29,67,B
2013,4163,Female,Johor,19,8,8,3,38,40,78,B
2012,4164,Male,Johor,13,8,6,4,31,24,55,C
2018,4165,Male,Sarawak,21,10,6,2,39,28,67,B
2014,4166,Female,Sarawak,17,6,3,4,30,35,65,B
2018,4167,Male,Malacca,17,7,9,2,35,31,66,B
2015,4168,Female,Kelantan,15,9,5,3,32,27,59,C
2015,4169,Female,Sabah,16,4,9,3,32,40,72,B
2017,4170,Female,Perak,15,4,3,1,23,38,61,B
2019,4171,Female,Johor,20,5,5,4,34,36,70,B
2012,4172,Male,Sabah,16,8,8,1,33,26,59,C
2015,4173,Female,Kedah,15,5,5,3,28,36,64,B
2017,4174,Female,Pahang,15,3,3,4,25,25,50,C
2019,4175,Male,Sarawak,15,6,8,3,32,35,67,B
2014,4176,Male,Pahang,20,5,10,4,39,33,72,B
2015,4177,Female,Kelantan,17,7,6,2,32,29,61,B
2015,4178,Male,Johor,17,7,4,3,31,23,54,C
2012,4179,Male,Malacca,14,6,7,5,32,23,55,C
2016,4180,Male,Terengganu,13,10,8,4,35,25,60,B
2014,4181,Female,Perak,20,10,8,1,39,26,65,B
2015,4182,Male,Perak,20,10,8,5,43,25,68,B
2019,4183,Male,Terengganu,19,9,4,3,35,38,73,B
2019,4184,Male,Pahang,20,9,4,4,37,31,68,B
2014,4185,Female,Perlis,20,7,4,5,36,40,76,B
2018,4186,Female,Kedah,19,5,8,5,37,25,62,B
2015,4187,Female,Pahang,18,8,8,1,35,36,71,B
2015,4188,Male,Negeri Sembilan,19,6,9,4,38,39,77,B
2015,4189,Female,Perlis,16,10,9,5,40,34,74,B
2018,4190,Female,Kedah,20,4,10,2,36,36,72,B
2018,4191,Female,Pahang,20,9,10,5,44,35,79,A
2015,4192,Male,Malacca,13,6,4,1,24,23,47,F
2012,4193,Male,Pahang,14,9,5,3,31,40,71,B
2019,4194,Female,Negeri Sembilan,16,6,10,2,34,29,63,B
2018,4195,Female,Kelantan,21,10,5,5,41,34,75,B
2016,4196,Female,Perlis,15,3,6,4,28,34,62,B
2018,4197,Male,Pahang,13,4,9,4,30,28,58,C
2017,4198,Male,Perlis,15,3,10,2,30,38,68,B
2012,4199,Female,Perak,19,4,5,3,31,31,62,B
2014,4200,Male,Negeri Sembilan,14,3,8,5,30,28,58,C
2019,4201,Male,Kelantan,17,6,8,3,34,34,68,B
2017,4202,Female,Sabah,20,6,8,5,39,22,61,B
2013,4203,Female,Terengganu,18,3,7,4,32,26,58,C
2013,4204,Female,Negeri Sembilan,20,10,7,4,41,32,73,B
2012,4205,Male,Kedah,16,3,3,4,26,22,48,F
2019,4206,Male,Perak,21,8,8,2,39,23,62,B
2019,4207,Male,Pahang,17,9,3,2,31,28,59,C
2016,4208,Male,Terengganu,13,10,7,4,34,35,69,B
2016,4209,Female,Perak,15,3,3,1,22,35,57,C
2016,4210,Female,Sarawak,17,3,5,4,29,36,65,B
2015,4211,Male,Pahang,21,8,5,2,36,34,70,B
2013,4212,Male,Perlis,20,6,9,4,39,36,75,B
2015,4213,Male,Sarawak,16,10,9,1,36,37,73,B
2019,4214,Female,Penang,20,7,8,3,38,34,72,B
2017,4215,Female,Perak,19,10,8,2,39,29,68,B
2015,4216,Female,Kedah,19,9,10,3,41,34,75,B
2016,4217,Female,Selangor,20,7,8,3,38,30,68,B
2014,4218,Female,Kedah,15,4,9,2,30,36,66,B
2016,4219,Male,Selangor,21,4,3,4,32,27,59,C
2014,4220,Female,Kedah,15,6,8,4,33,30,63,B
2019,4221,Female,Pahang,17,4,8,1,30,33,63,B
2013,4222,Female,Kelantan,16,5,3,3,27,25,52,C
2018,4223,Female,Negeri Sembilan,21,7,5,2,35,40,75,B
2016,4224,Female,Malacca,17,4,3,1,25,34,59,C
2014,4225,Male,Perlis,21,10,6,3,40,30,70,B
2014,4226,Male,Terengganu,17,5,7,2,31,22,53,C
2019,4227,Male,Malacca,15,6,3,1,25,34,59,C
2017,4228,Male,Negeri Sembilan,18,7,5,4,34,23,57,C
2019,4229,Male,Pahang,17,5,7,1,30,38,68,B
2013,4230,Female,Terengganu,19,10,4,5,38,28,66,B
2014,4231,Female,Terengganu,19,8,7,3,37,40,77,B
2013,4232,Male,Selangor,15,6,7,5,33,38,71,B
2016,4233,Female,Kelantan,19,4,3,3,29,23,52,C
2012,4234,Male,Perlis,17,5,6,2,30,22,52,C
2016,4235,Female,Kedah,15,4,10,2,31,38,69,B
2015,4236,Female,Perlis,19,5,7,2,33,36,69,B
2017,4237,Male,Negeri Sembilan,18,3,8,1,30,25,55,C
2015,4238,Male,Kelantan,18,8,7,4,37,36,73,B
2012,4239,Male,Johor,14,10,9,3,36,28,64,B
2014,4240,Female,Perak,13,3,4,5,25,29,54,C
2015,4241,Male,Sabah,20,9,7,2,38,22,60,B
2017,4242,Male,Johor,13,9,10,5,37,37,74,B
2013,4243,Female,Penang,17,6,6,2,31,29,60,B
2015,4244,Female,Malacca,18,9,4,3,34,38,72,B
2019,4245,Female,Penang,16,10,7,5,38,26,64,B
2016,4246,Female,Sarawak,16,7,7,4,34,33,67,B
2015,4247,Male,Perlis,13,6,3,2,24,28,52,C
2014,4248,Female,Pahang,18,5,6,4,33,32,65,B
2013,4249,Male,Sabah,17,9,6,4,36,29,65,B
2014,4250,Male,Terengganu,16,7,6,3,32,38,70,B
2014,4251,Female,Sabah,15,6,9,1,31,27,58,C
2016,4252,Male,Perlis,14,5,4,4,27,26,53,C
2019,4253,Male,Negeri Sembilan,13,7,9,5,34,38,72,B
2012,4254,Female,Sabah,13,9,10,4,36,27,63,B
2013,4255,Female,Kedah,18,5,5,3,31,35,66,B
2017,4256,Male,Sabah,15,9,6,1,31,38,69,B
2014,4257,Female,Sabah,13,6,5,3,27,22,49,F
2012,4258,Male,Kelantan,17,4,6,1,28,33,61,B
2012,4259,Female,Terengganu,20,8,5,5,38,33,71,B
2013,4260,Male,Pahang,20,8,10,4,42,31,73,B
2012,4261,Female,Selangor,16,6,7,2,31,39,70,B
2016,4262,Male,Negeri Sembilan,16,5,3,2,26,22,48,F
2017,4263,Female,Perak,20,8,5,3,36,33,69,B
2018,4264,Female,Penang,15,10,9,5,39,34,73,B
2017,4265,Female,Negeri Sembilan,17,6,10,5,38,35,73,B
2016,4266,Female,Penang,15,6,8,2,31,28,59,C
2013,4267,Female,Kelantan,18,8,10,1,37,39,76,B
2018,4268,Female,Kedah,18,10,9,1,38,24,62,B
2012,4269,Male,Selangor,14,4,6,3,27,22,49,F
2017,4270,Male,Perlis,21,4,3,5,33,33,66,B
2012,4271,Female,Selangor,20,10,4,4,38,32,70,B
2019,4272,Female,Johor,17,7,7,2,33,31,64,B
2014,4273,Female,Kedah,20,10,6,2,38,26,64,B
2016,4274,Male,Perlis,20,6,3,1,30,38,68,B
2018,4275,Female,Perlis,19,5,5,4,33,25,58,C
2014,4276,Male,Kelantan,17,7,6,2,32,23,55,C
2016,4277,Female,Selangor,19,4,8,1,32,27,59,C
2019,4278,Male,Selangor,17,8,4,1,30,39,69,B
2014,4279,Male,Negeri Sembilan,19,6,9,1,35,30,65,B
2012,4280,Female,Terengganu,19,3,10,1,33,29,62,B
2012,4281,Female,Penang,17,3,6,3,29,33,62,B
2015,4282,Female,Selangor,20,3,7,5,35,29,64,B
2019,4283,Female,Malacca,14,7,5,5,31,33,64,B
2013,4284,Female,Perlis,18,9,9,1,37,40,77,B
2016,4285,Male,Terengganu,19,5,9,1,34,25,59,C
2013,4286,Male,Pahang,19,5,4,3,31,38,69,B
2014,4287,Female,Negeri Sembilan,14,4,4,4,26,26,52,C
2013,4288,Female,Sarawak,16,8,9,4,37,34,71,B
2013,4289,Female,Selangor,20,5,7,1,33,22,55,C
2015,4290,Female,Perak,15,10,4,5,34,39,73,B
2012,4291,Male,Selangor,21,10,5,4,40,28,68,B
2013,4292,Female,Sabah,15,6,10,1,32,37,69,B
2018,4293,Female,Penang,16,5,3,2,26,25,51,C
2012,4294,Female,Kelantan,16,7,4,5,32,27,59,C
2019,4295,Male,Kedah,16,3,6,3,28,34,62,B
2019,4296,Female,Negeri Sembilan,17,10,10,5,42,40,82,A
2016,4297,Male,Perlis,18,9,7,3,37,34,71,B
2012,4298,Female,Perlis,21,9,7,5,42,28,70,B
2015,4299,Male,Sabah,17,10,9,3,39,25,64,B
2019,4300,Female,Johor,16,9,6,4,35,23,58,C
2018,4301,Male,Malacca,17,10,8,4,39,33,72,B
2019,4302,Male,Sarawak,20,3,5,5,33,26,59,C
2014,4303,Female,Kelantan,15,5,4,4,28,35,63,B
2018,4304,Female,Sabah,17,6,3,1,27,26,53,C
2015,4305,Male,Sarawak,16,7,3,5,31,27,58,C
2014,4306,Female,Negeri Sembilan,19,9,8,2,38,39,77,B
2016,4307,Female,Sabah,20,5,9,5,39,36,75,B
2016,4308,Female,Sabah,14,3,5,3,25,31,56,C
2014,4309,Female,Penang,19,6,3,4,32,37,69,B
2016,4310,Male,Negeri Sembilan,17,6,10,2,35,36,71,B
2015,4311,Female,Pahang,18,7,5,5,35,26,61,B
2016,4312,Male,Johor,15,8,4,5,32,24,56,C
2013,4313,Male,Negeri Sembilan,15,6,7,2,30,38,68,B
2015,4314,Female,Johor,16,10,10,2,38,39,77,B
2015,4315,Male,Perlis,14,6,3,4,27,25,52,C
2016,4316,Female,Kedah,14,6,3,1,24,33,57,C
2018,4317,Male,Selangor,17,5,8,2,32,29,61,B
2018,4318,Female,Sabah,21,4,5,5,35,37,72,B
2016,4319,Male,Sabah,18,5,5,1,29,27,56,C
2014,4320,Male,Negeri Sembilan,18,4,10,2,34,25,59,C
2014,4321,Male,Perak,18,5,7,1,31,30,61,B
2019,4322,Male,Selangor,21,3,4,4,32,25,57,C
2019,4323,Female,Pahang,13,10,4,5,32,35,67,B
2017,4324,Male,Kedah,21,7,5,1,34,35,69,B
2018,4325,Male,Perlis,19,8,5,4,36,34,70,B
2017,4326,Male,Negeri Sembilan,13,6,4,1,24,38,62,B
2017,4327,Female,Kelantan,20,9,9,4,42,29,71,B
2018,4328,Male,Kelantan,15,3,5,3,26,24,50,C
2017,4329,Male,Sarawak,15,5,7,5,32,24,56,C
2013,4330,Female,Sabah,19,10,9,2,40,22,62,B
2018,4331,Male,Perak,16,7,7,1,31,27,58,C
2018,4332,Female,Terengganu,15,8,8,3,34,25,59,C
2012,4333,Female,Selangor,17,9,10,4,40,38,78,B
2016,4334,Male,Negeri Sembilan,18,5,4,3,30,34,64,B
2018,4335,Female,Penang,21,3,5,3,32,29,61,B
2012,4336,Female,Perlis,15,5,3,5,28,29,57,C
2012,4337,Female,Sabah,13,4,8,2,27,27,54,C
2016,4338,Male,Johor,16,9,7,1,33,36,69,B
2013,4339,Male,Johor,16,3,6,3,28,30,58,C
2018,4340,Female,Perlis,18,7,9,4,38,23,61,B
2012,4341,Male,Sabah,14,6,4,3,27,26,53,C
2018,4342,Female,Pahang,21,5,3,1,30,34,64,B
2018,4343,Male,Terengganu,18,4,10,1,33,40,73,B
2018,4344,Male,Terengganu,18,9,6,1,34,33,67,B
2013,4345,Male,Malacca,21,6,4,4,35,26,61,B
2015,4346,Female,Penang,17,10,7,3,37,31,68,B
2018,4347,Female,Malacca,18,5,10,1,34,33,67,B
2016,4348,Male,Malacca,19,8,9,2,38,30,68,B
2019,4349,Female,Malacca,14,9,8,4,35,22,57,C
2018,4350,Female,Terengganu,17,8,7,4,36,33,69,B
2012,4351,Female,Johor,20,8,4,4,36,23,59,C
2015,4352,Female,Sarawak,15,9,4,4,32,37,69,B
2016,4353,Male,Pahang,20,3,8,3,34,38,72,B
2018,4354,Male,Malacca,17,3,5,5,30,30,60,B
2015,4355,Female,Johor,21,9,3,3,36,26,62,B
2013,4356,Male,Selangor,18,10,6,2,36,26,62,B
2018,4357,Female,Malacca,17,10,10,5,42,26,68,B
2014,4358,Female,Johor,21,3,5,1,30,22,52,C
2012,4359,Male,Selangor,21,3,5,4,33,40,73,B
2018,4360,Female,Kelantan,14,7,7,3,31,30,61,B
2014,4361,Female,Pahang,17,8,3,3,31,36,67,B
2014,4362,Female,Malacca,16,4,5,5,30,29,59,C
2017,4363,Female,Sarawak,17,5,5,4,31,40,71,B
2015,4364,Male,Kelantan,13,4,4,3,24,40,64,B
2018,4365,Male,Malacca,18,3,8,1,30,23,53,C
2019,4366,Male,Terengganu,18,10,5,4,37,37,74,B
2017,4367,Female,Sabah,14,6,8,4,32,36,68,B
2016,4368,Female,Perlis,20,7,4,4,35,35,70,B
2014,4369,Male,Perak,13,5,3,3,24,37,61,B
2018,4370,Male,Sabah,18,10,5,5,38,37,75,B
2013,4371,Male,Kelantan,20,4,9,1,34,25,59,C
2014,4372,Male,Penang,19,9,6,2,36,27,63,B
2014,4373,Female,Johor,21,7,10,4,42,23,65,B
2016,4374,Male,Negeri Sembilan,20,10,8,4,42,37,79,A
2016,4375,Male,Negeri Sembilan,15,9,5,1,30,23,53,C
2014,4376,Female,Pahang,14,4,6,4,28,35,63,B
2018,4377,Male,Sarawak,15,3,9,1,28,27,55,C
2015,4378,Female,Sarawak,18,3,6,1,28,37,65,B
2016,4379,Male,Sabah,20,6,3,2,31,32,63,B
2018,4380,Male,Kedah,16,9,4,1,30,29,59,C
2012,4381,Male,Johor,15,6,8,4,33,29,62,B
2013,4382,Male,Negeri Sembilan,18,4,8,2,32,24,56,C
2012,4383,Male,Malacca,17,7,5,1,30,31,61,B
2017,4384,Male,Perlis,19,5,6,3,33,24,57,C
2014,4385,Male,Penang,16,3,6,5,30,35,65,B
2012,4386,Female,Perlis,17,6,8,2,33,32,65,B
2013,4387,Female,Pahang,16,8,5,1,30,25,55,C
2014,4388,Male,Negeri Sembilan,14,5,3,2,24,35,59,C
2013,4389,Female,Terengganu,17,6,7,1,31,39,70,B
2016,4390,Male,Sarawak,15,10,4,1,30,25,55,C
2016,4391,Male,Malacca,19,6,3,1,29,31,60,B
2019,4392,Female,Terengganu,14,6,7,5,32,23,55,C
2018,4393,Male,Terengganu,14,3,7,4,28,36,64,B
2013,4394,Male,Pahang,16,8,9,2,35,40,75,B
2017,4395,Male,Malacca,15,7,4,1,27,40,67,B
2014,4396,Female,Sabah,16,5,6,3,30,22,52,C
2019,4397,Male,Sarawak,18,7,4,4,33,22,55,C
2017,4398,Male,Kelantan,16,7,9,3,35,34,69,B
2017,4399,Female,Perak,15,10,4,2,31,35,66,B
2012,4400,Male,Perlis,13,4,8,5,30,37,67,B
2018,4401,Male,Johor,14,4,5,4,27,35,62,B
2014,4402,Male,Johor,17,7,8,3,35,23,58,C
2016,4403,Male,Kelantan,15,9,6,5,35,28,63,B
2019,4404,Female,Perlis,15,7,9,5,36,24,60,B
2013,4405,Male,Terengganu,18,9,8,5,40,37,77,B
2012,4406,Female,Negeri Sembilan,21,7,6,5,39,24,63,B
2018,4407,Male,Johor,15,7,4,2,28,31,59,C
2013,4408,Male,Negeri Sembilan,19,9,4,3,35,31,66,B
2019,4409,Male,Perak,16,3,9,5,33,35,68,B
2017,4410,Female,Selangor,15,10,3,3,31,30,61,B
2018,4411,Female,Negeri Sembilan,15,5,8,1,29,33,62,B
2019,4412,Female,Sarawak,14,10,4,4,32,30,62,B
2016,4413,Male,Kelantan,13,10,5,5,33,26,59,C
2017,4414,Female,Sarawak,19,8,9,4,40,25,65,B
2012,4415,Male,Sabah,19,4,4,5,32,25,57,C
2018,4416,Male,Selangor,20,5,3,5,33,28,61,B
2018,4417,Male,Kelantan,13,4,6,2,25,40,65,B
2017,4418,Female,Terengganu,16,6,3,2,27,27,54,C
2015,4419,Male,Terengganu,13,3,10,3,29,31,60,B
2013,4420,Male,Selangor,21,5,9,4,39,38,77,B
2016,4421,Male,Kedah,16,5,3,4,28,29,57,C
2015,4422,Male,Terengganu,13,9,9,1,32,29,61,B
2018,4423,Male,Selangor,15,5,6,3,29,27,56,C
2012,4424,Female,Perlis,21,10,6,5,42,33,75,B
2014,4425,Female,Perlis,18,10,9,2,39,37,76,B
2012,4426,Female,Perak,19,3,9,4,35,34,69,B
2018,4427,Female,Penang,20,10,7,1,38,40,78,B
2015,4428,Female,Negeri Sembilan,15,7,7,4,33,40,73,B
2014,4429,Female,Kedah,15,7,8,3,33,35,68,B
2015,4430,Male,Kelantan,21,4,5,4,34,35,69,B
2016,4431,Male,Johor,15,3,4,1,23,33,56,C
2013,4432,Male,Johor,16,9,4,5,34,34,68,B
2017,4433,Male,Malacca,21,10,6,1,38,27,65,B
2014,4434,Female,Kedah,18,8,4,3,33,32,65,B
2017,4435,Male,Penang,18,5,9,4,36,26,62,B
2014,4436,Female,Pahang,17,8,5,2,32,25,57,C
2018,4437,Female,Sarawak,13,4,5,3,25,24,49,F
2014,4438,Female,Negeri Sembilan,13,5,3,1,22,33,55,C
2014,4439,Male,Pahang,13,7,5,3,28,37,65,B
2019,4440,Male,Sarawak,19,3,3,3,28,33,61,B
2013,4441,Female,Johor,13,6,4,4,27,28,55,C
2013,4442,Male,Malacca,16,8,7,5,36,36,72,B
2015,4443,Female,Perak,13,6,10,1,30,33,63,B
2012,4444,Male,Perak,13,4,9,4,30,23,53,C
2012,4445,Male,Kedah,13,8,3,4,28,26,54,C
2019,4446,Male,Sarawak,17,9,8,2,36,38,74,B
2019,4447,Female,Selangor,15,5,5,1,26,27,53,C
2017,4448,Female,Malacca,16,9,3,5,33,30,63,B
2016,4449,Female,Pahang,21,4,9,4,38,23,61,B
2014,4450,Male,Kedah,18,9,7,3,37,30,67,B
2013,4451,Female,Pahang,18,6,7,4,35,27,62,B
2019,4452,Male,Negeri Sembilan,13,10,8,5,36,28,64,B
2014,4453,Female,Johor,19,10,5,3,37,39,76,B
2014,4454,Male,Sabah,20,7,7,5,39,38,77,B
2012,4455,Female,Malacca,16,8,4,1,29,22,51,C
2019,4456,Male,Penang,19,9,8,4,40,24,64,B
2017,4457,Female,Kedah,16,7,3,2,28,35,63,B
2018,4458,Male,Sarawak,15,10,5,4,34,38,72,B
2018,4459,Male,Negeri Sembilan,13,6,8,3,30,28,58,C
2019,4460,Male,Terengganu,14,5,6,4,29,32,61,B
2019,4461,Male,Johor,17,5,9,3,34,32,66,B
2013,4462,Male,Kelantan,17,3,9,3,32,27,59,C
2015,4463,Female,Malacca,14,5,9,2,30,40,70,B
2012,4464,Male,Terengganu,21,7,5,4,37,40,77,B
2015,4465,Female,Negeri Sembilan,17,7,9,5,38,25,63,B
2018,4466,Female,Sabah,13,4,6,3,26,24,50,C
2015,4467,Female,Johor,17,5,9,4,35,22,57,C
2012,4468,Female,Selangor,15,6,9,5,35,31,66,B
2019,4469,Male,Penang,17,5,5,3,30,38,68,B
2015,4470,Female,Sabah,19,3,7,5,34,32,66,B
2012,4471,Male,Penang,18,6,5,1,30,27,57,C
2017,4472,Female,Johor,14,5,7,2,28,23,51,C
2017,4473,Male,Selangor,20,9,9,3,41,29,70,B
2018,4474,Male,Sarawak,19,8,8,4,39,33,72,B
2015,4475,Male,Perak,21,9,4,5,39,26,65,B
2015,4476,Male,Perak,13,5,4,2,24,26,50,C
2018,4477,Female,Kelantan,21,8,6,2,37,22,59,C
2019,4478,Male,Sabah,15,9,4,1,29,30,59,C
2014,4479,Female,Terengganu,13,7,5,5,30,30,60,B
2015,4480,Female,Perlis,14,8,7,4,33,40,73,B
2013,4481,Female,Perak,13,4,7,1,25,28,53,C
2018,4482,Male,Perak,21,5,9,3,38,22,60,B
2018,4483,Male,Perak,19,8,9,3,39,37,76,B
2013,4484,Female,Perak,15,5,6,1,27,26,53,C
2013,4485,Female,Sabah,18,6,6,2,32,37,69,B
2012,4486,Female,Penang,13,4,9,5,31,38,69,B
2018,4487,Male,Perak,16,8,4,4,32,36,68,B
2015,4488,Female,Negeri Sembilan,17,7,7,4,35,33,68,B
2012,4489,Male,Johor,21,5,3,3,32,27,59,C
2017,4490,Male,Malacca,18,4,4,3,29,30,59,C
2014,4491,Female,Negeri Sembilan,21,3,10,2,36,25,61,B
2019,4492,Male,Negeri Sembilan,19,8,7,5,39,27,66,B
2017,4493,Male,Pahang,17,7,7,3,34,26,60,B
2017,4494,Male,Perlis,20,3,5,3,31,27,58,C
2015,4495,Female,Negeri Sembilan,19,9,5,3,36,28,64,B
2016,4496,Female,Pahang,21,6,7,3,37,25,62,B
2018,4497,Female,Negeri Sembilan,14,9,4,3,30,33,63,B
2016,4498,Female,Kedah,16,6,6,4,32,39,71,B
2013,4499,Female,Pahang,20,10,10,1,41,29,70,B
2013,4500,Male,Sabah,15,10,5,5,35,27,62,B
2017,4501,Male,Perlis,16,10,7,1,34,28,62,B
2013,4502,Female,Terengganu,17,4,6,2,29,31,60,B
2018,4503,Female,Perlis,17,6,5,4,32,25,57,C
2013,4504,Female,Malacca,20,4,3,3,30,39,69,B
2014,4505,Female,Perak,17,9,10,3,39,31,70,B
2019,4506,Male,Selangor,20,8,6,3,37,35,72,B
2014,4507,Female,Terengganu,21,3,4,2,30,36,66,B
2015,4508,Male,Kelantan,14,8,5,5,32,39,71,B
2016,4509,Female,Pahang,21,7,7,2,37,28,65,B
2013,4510,Male,Johor,16,6,9,2,33,28,61,B
2018,4511,Female,Perlis,17,3,6,4,30,33,63,B
2013,4512,Male,Terengganu,21,3,9,3,36,27,63,B
2019,4513,Female,Perak,13,9,7,5,34,37,71,B
2018,4514,Male,Kelantan,19,4,3,2,28,27,55,C
2017,4515,Female,Johor,13,9,9,3,34,26,60,B
2018,4516,Male,Negeri Sembilan,15,5,5,4,29,36,65,B
2018,4517,Female,Perak,13,6,3,4,26,37,63,B
2018,4518,Male,Sabah,21,9,7,2,39,22,61,B
2017,4519,Male,Perlis,15,5,5,4,29,29,58,C
2019,4520,Male,Pahang,21,7,8,1,37,39,76,B
2017,4521,Male,Sabah,15,8,8,2,33,37,70,B
2018,4522,Male,Kelantan,13,5,6,2,26,34,60,B
2015,4523,Female,Kelantan,17,3,5,1,26,25,51,C
2014,4524,Female,Sabah,20,3,9,2,34,29,63,B
2013,4525,Female,Pahang,19,4,5,5,33,28,61,B
2015,4526,Male,Kelantan,14,3,7,4,28,33,61,B
2018,4527,Male,Selangor,17,3,9,3,32,23,55,C
2014,4528,Female,Pahang,21,3,6,1,31,28,59,C
2014,4529,Male,Sabah,18,4,6,3,31,29,60,B
2017,4530,Male,Penang,17,7,3,3,30,30,60,B
2012,4531,Female,Kelantan,17,8,3,5,33,28,61,B
2014,4532,Male,Kelantan,15,9,4,5,33,22,55,C
2018,4533,Female,Terengganu,15,4,4,3,26,29,55,C
2019,4534,Male,Perak,13,4,9,3,29,37,66,B
2014,4535,Female,Penang,13,8,5,1,27,36,63,B
2014,4536,Female,Negeri Sembilan,20,9,10,2,41,25,66,B
2012,4537,Female,Sabah,18,8,6,1,33,25,58,C
2017,4538,Female,Perlis,21,9,6,5,41,28,69,B
2019,4539,Female,Kelantan,13,7,5,5,30,22,52,C
2016,4540,Male,Selangor,15,3,7,1,26,29,55,C
2015,4541,Female,Sarawak,16,3,8,2,29,23,52,C
2018,4542,Male,Sabah,20,5,5,3,33,25,58,C
2013,4543,Male,Sabah,14,3,5,3,25,30,55,C
2017,4544,Male,Kedah,15,3,4,5,27,35,62,B
2016,4545,Male,Johor,20,3,6,1,30,38,68,B
2016,4546,Female,Malacca,17,9,10,3,39,28,67,B
2014,4547,Female,Kelantan,16,5,7,5,33,28,61,B
2018,4548,Female,Johor,16,8,9,5,38,35,73,B
2012,4549,Male,Negeri Sembilan,16,8,8,3,35,38,73,B
2013,4550,Male,Penang,20,3,8,2,33,37,70,B
2014,4551,Male,Sabah,14,9,10,2,35,37,72,B
2018,4552,Male,Johor,17,8,7,5,37,28,65,B
2017,4553,Female,Kelantan,13,6,9,4,32,26,58,C
2017,4554,Male,Perak,20,9,8,5,42,37,79,A
2012,4555,Female,Perak,15,4,5,2,26,24,50,C
2012,4556,Male,Pahang,18,5,3,2,28,22,50,C
2015,4557,Male,Sabah,13,9,8,2,32,40,72,B
2015,4558,Male,Perak,16,5,7,5,33,26,59,C
2016,4559,Male,Pahang,17,6,8,1,32,40,72,B
2015,4560,Female,Sarawak,20,7,8,4,39,37,76,B
2016,4561,Female,Negeri Sembilan,18,7,9,1,35,24,59,C
2014,4562,Female,Perak,15,8,7,1,31,34,65,B
2013,4563,Female,Terengganu,13,7,3,1,24,38,62,B
2016,4564,Female,Sabah,16,6,6,2,30,39,69,B
2019,4565,Female,Perlis,13,8,8,2,31,32,63,B
2018,4566,Male,Perlis,18,8,6,3,35,31,66,B
2015,4567,Male,Perlis,15,5,7,3,30,29,59,C
2013,4568,Male,Kelantan,14,4,6,2,26,34,60,B
2019,4569,Female,Perlis,21,4,3,1,29,25,54,C
2013,4570,Female,Terengganu,13,6,3,2,24,27,51,C
2013,4571,Female,Pahang,18,3,9,4,34,36,70,B
2015,4572,Male,Kedah,13,9,4,5,31,30,61,B
2013,4573,Female,Perlis,13,10,3,2,28,24,52,C
2018,4574,Female,Perlis,17,5,10,4,36,34,70,B
2018,4575,Female,Selangor,19,5,5,3,32,29,61,B
2013,4576,Female,Johor,20,8,8,2,38,35,73,B
2017,4577,Male,Terengganu,15,8,9,1,33,35,68,B
2017,4578,Male,Kelantan,13,4,7,4,28,22,50,C
2012,4579,Female,Selangor,20,8,4,3,35,29,64,B
2013,4580,Female,Perlis,14,5,7,5,31,37,68,B
2017,4581,Female,Perlis,13,5,8,5,31,27,58,C
2014,4582,Male,Negeri Sembilan,21,8,3,5,37,37,74,B
2014,4583,Female,Perak,17,7,9,4,37,35,72,B
2016,4584,Male,Johor,19,6,9,5,39,23,62,B
2015,4585,Female,Penang,15,10,4,1,30,32,62,B
2017,4586,Female,Perak,21,5,8,1,35,33,68,B
2017,4587,Female,Johor,21,6,6,1,34,24,58,C
2017,4588,Male,Perlis,15,10,8,4,37,31,68,B
2018,4589,Male,Perlis,18,3,7,2,30,32,62,B
2017,4590,Male,Sabah,15,5,3,1,24,40,64,B
2015,4591,Female,Sarawak,16,4,4,2,26,34,60,B
2014,4592,Male,Perak,16,7,6,3,32,22,54,C
2014,4593,Female,Penang,13,8,10,2,33,40,73,B
2014,4594,Female,Kedah,14,9,9,1,33,39,72,B
2013,4595,Male,Malacca,14,10,6,4,34,24,58,C
2014,4596,Male,Terengganu,16,4,7,2,29,26,55,C
2015,4597,Female,Selangor,17,9,4,2,32,28,60,B
2015,4598,Male,Johor,14,9,6,2,31,37,68,B
2019,4599,Female,Selangor,20,4,8,5,37,34,71,B
2012,4600,Male,Negeri Sembilan,20,10,8,3,41,32,73,B
2014,4601,Female,Johor,16,5,9,4,34,35,69,B
2013,4602,Female,Malacca,21,8,7,5,41,32,73,B
2016,4603,Male,Perak,19,4,10,5,38,22,60,B
2019,4604,Male,Penang,15,9,6,5,35,37,72,B
2016,4605,Female,Kelantan,19,9,5,3,36,26,62,B
2019,4606,Male,Penang,15,10,9,2,36,37,73,B
2017,4607,Female,Perak,21,3,4,2,30,24,54,C
2019,4608,Female,Sarawak,18,4,5,2,29,25,54,C
2013,4609,Female,Sarawak,16,4,5,2,27,31,58,C
2015,4610,Male,Negeri Sembilan,20,8,5,5,38,25,63,B
2013,4611,Male,Johor,19,8,3,1,31,23,54,C
2015,4612,Female,Selangor,21,10,5,1,37,32,69,B
2014,4613,Male,Perlis,18,7,5,4,34,34,68,B
2017,4614,Female,Selangor,15,8,7,5,35,37,72,B
2017,4615,Female,Sarawak,14,10,8,1,33,30,63,B
2015,4616,Female,Terengganu,13,6,6,5,30,31,61,B
2018,4617,Male,Perlis,13,6,9,4,32,39,71,B
2012,4618,Female,Johor,19,3,9,3,34,29,63,B
2019,4619,Female,Penang,13,7,4,3,27,22,49,F
2019,4620,Male,Selangor,19,7,4,5,35,38,73,B
2018,4621,Male,Perlis,19,10,10,4,43,27,70,B
2017,4622,Male,Johor,17,5,5,3,30,23,53,C
2016,4623,Female,Kelantan,14,5,9,1,29,29,58,C
2014,4624,Male,Terengganu,15,5,3,1,24,31,55,C
2017,4625,Male,Kelantan,21,3,9,4,37,26,63,B
2017,4626,Female,Kedah,20,4,10,5,39,25,64,B
2018,4627,Male,Kedah,19,4,6,2,31,34,65,B
2013,4628,Female,Malacca,14,10,10,1,35,38,73,B
2012,4629,Male,Kedah,15,6,3,3,27,37,64,B
2012,4630,Male,Sabah,20,4,5,3,32,26,58,C
2012,4631,Female,Malacca,14,9,7,3,33,23,56,C
2016,4632,Male,Johor,13,10,4,3,30,26,56,C
2016,4633,Male,Negeri Sembilan,14,6,10,5,35,40,75,B
2016,4634,Female,Sarawak,20,3,8,5,36,34,70,B
2014,4635,Female,Johor,16,4,9,1,30,32,62,B
2018,4636,Male,Perlis,15,4,9,4,32,31,63,B
2018,4637,Female,Johor,16,5,5,1,27,35,62,B
2018,4638,Female,Sarawak,20,4,6,3,33,39,72,B
2016,4639,Male,Selangor,21,8,4,5,38,33,71,B
2019,4640,Female,Pahang,17,9,3,3,32,36,68,B
2014,4641,Male,Sarawak,16,4,8,4,32,39,71,B
2015,4642,Female,Sabah,15,4,5,5,29,32,61,B
2019,4643,Male,Perak,20,7,9,1,37,25,62,B
2013,4644,Male,Kelantan,20,3,3,2,28,36,64,B
2015,4645,Male,Sabah,16,9,4,4,33,30,63,B
2015,4646,Male,Kedah,21,6,7,5,39,33,72,B
2012,4647,Female,Negeri Sembilan,17,9,8,4,38,34,72,B
2015,4648,Male,Selangor,18,6,9,3,36,24,60,B
2018,4649,Male,Sabah,15,4,5,4,28,22,50,C
2017,4650,Male,Kedah,21,5,5,2,33,40,73,B
2015,4651,Male,Johor,20,8,5,5,38,26,64,B
2017,4652,Male,Kelantan,17,7,10,1,35,24,59,C
2017,4653,Female,Johor,18,9,4,3,34,23,57,C
2015,4654,Male,Sabah,20,9,5,5,39,24,63,B
2015,4655,Male,Penang,19,9,7,3,38,34,72,B
2016,4656,Male,Negeri Sembilan,19,8,8,1,36,34,70,B
2012,4657,Male,Kedah,19,9,10,3,41,37,78,B
2019,4658,Male,Perlis,17,4,7,3,31,29,60,B
2014,4659,Male,Negeri Sembilan,16,5,4,4,29,34,63,B
2019,4660,Female,Pahang,15,9,5,3,32,35,67,B
2015,4661,Female,Perak,14,6,3,5,28,31,59,C
2016,4662,Female,Negeri Sembilan,20,4,7,4,35,39,74,B
2019,4663,Female,Sabah,17,10,10,2,39,25,64,B
2013,4664,Male,Johor,18,3,10,3,34,34,68,B
2017,4665,Female,Selangor,20,6,4,2,32,30,62,B
2018,4666,Female,Sabah,20,9,5,3,37,39,76,B
2016,4667,Male,Negeri Sembilan,13,9,9,3,34,30,64,B
2012,4668,Female,Selangor,18,7,3,4,32,38,70,B
2019,4669,Male,Pahang,20,9,8,4,41,28,69,B
2019,4670,Female,Sarawak,19,8,3,4,34,33,67,B
2016,4671,Female,Penang,15,9,3,2,29,29,58,C
2014,4672,Male,Selangor,13,4,6,4,27,35,62,B
2014,4673,Male,Sarawak,14,3,10,1,28,33,61,B
2015,4674,Male,Kedah,14,4,5,3,26,25,51,C
2016,4675,Female,Selangor,15,3,4,2,24,38,62,B
2017,4676,Male,Johor,21,10,8,4,43,37,80,A
2015,4677,Female,Terengganu,20,6,5,2,33,28,61,B
2019,4678,Female,Malacca,17,7,9,5,38,33,71,B
2017,4679,Male,Kelantan,17,4,8,2,31,33,64,B
2012,4680,Male,Johor,16,5,5,5,31,23,54,C
2015,4681,Male,Kedah,16,8,8,2,34,22,56,C
2016,4682,Female,Perak,20,5,9,3,37,39,76,B
2016,4683,Female,Johor,16,7,8,3,34,37,71,B
2014,4684,Male,Kelantan,19,10,9,5,43,32,75,B
2012,4685,Male,Kedah,18,6,10,5,39,25,64,B
2018,4686,Female,Penang,18,4,10,2,34,25,59,C
2018,4687,Male,Perlis,15,4,7,4,30,28,58,C
2019,4688,Male,Selangor,21,3,4,2,30,23,53,C
2014,4689,Female,Selangor,21,8,5,2,36,31,67,B
2018,4690,Female,Terengganu,19,3,5,2,29,38,67,B
2017,4691,Female,Penang,13,6,4,5,28,30,58,C
2013,4692,Female,Kelantan,17,10,5,2,34,23,57,C
2013,4693,Female,Sabah,15,4,4,1,24,33,57,C
2013,4694,Male,Perak,20,6,8,4,38,26,64,B
2012,4695,Female,Malacca,21,3,10,2,36,30,66,B
2014,4696,Female,Selangor,21,9,5,1,36,31,67,B
2014,4697,Female,Sabah,14,8,6,4,32,23,55,C
2015,4698,Male,Pahang,17,4,8,3,32,34,66,B
2018,4699,Male,Selangor,21,4,9,2,36,40,76,B
2016,4700,Male,Sabah,20,3,6,4,33,24,57,C
2016,4701,Female,Kelantan,14,8,5,1,28,24,52,C
2013,4702,Female,Kedah,20,9,7,1,37,24,61,B
2013,4703,Female,Johor,13,9,8,2,32,33,65,B
2015,4704,Female,Malacca,17,5,4,5,31,39,70,B
2017,4705,Female,Selangor,16,5,3,2,26,37,63,B
2012,4706,Male,Penang,14,10,5,2,31,25,56,C
2017,4707,Female,Kelantan,20,4,7,5,36,35,71,B
2019,4708,Male,Penang,16,5,8,2,31,34,65,B
2017,4709,Male,Pahang,17,8,10,5,40,23,63,B
2016,4710,Male,Sarawak,21,8,10,2,41,25,66,B
2013,4711,Female,Kedah,15,3,9,4,31,30,61,B
2019,4712,Female,Terengganu,18,5,10,3,36,28,64,B
2013,4713,Male,Malacca,17,7,8,2,34,30,64,B
2016,4714,Male,Terengganu,17,9,10,5,41,35,76,B
2014,4715,Female,Pahang,21,3,9,2,35,32,67,B
2018,4716,Male,Kedah,13,6,9,2,30,27,57,C
2014,4717,Female,Sabah,13,3,6,4,26,40,66,B
2019,4718,Male,Kelantan,18,7,3,5,33,26,59,C
2012,4719,Female,Sarawak,20,4,9,2,35,39,74,B
2019,4720,Female,Negeri Sembilan,16,9,3,4,32,31,63,B
2013,4721,Female,Kedah,19,5,10,3,37,27,64,B
2015,4722,Female,Negeri Sembilan,13,7,4,3,27,26,53,C
2013,4723,Female,Kedah,16,6,5,3,30,22,52,C
2016,4724,Female,Negeri Sembilan,16,6,3,1,26,33,59,C
2016,4725,Male,Pahang,20,4,7,3,34,32,66,B
2016,4726,Male,Malacca,21,4,10,1,36,24,60,B
2019,4727,Male,Terengganu,20,6,3,5,34,22,56,C
2019,4728,Male,Penang,19,10,4,3,36,36,72,B
2012,4729,Male,Selangor,18,8,7,2,35,30,65,B
2013,4730,Male,Negeri Sembilan,18,9,3,3,33,38,71,B
2017,4731,Male,Malacca,15,4,5,4,28,30,58,C
2014,4732,Male,Selangor,14,7,6,1,28,25,53,C
2012,4733,Female,Terengganu,17,9,4,2,32,38,70,B
2013,4734,Female,Johor,17,6,9,4,36,36,72,B
2018,4735,Male,Sarawak,13,10,5,3,31,28,59,C
2018,4736,Female,Perlis,18,3,7,4,32,34,66,B
2018,4737,Male,Johor,15,4,4,2,25,23,48,F
2016,4738,Male,Perlis,19,10,3,4,36,38,74,B
2014,4739,Male,Penang,21,10,3,5,39,37,76,B
2013,4740,Male,Perlis,18,8,3,5,34,22,56,C
2017,4741,Female,Negeri Sembilan,17,10,7,1,35,37,72,B
2017,4742,Male,Sarawak,14,3,6,4,27,32,59,C
2018,4743,Male,Kedah,18,4,3,2,27,33,60,B
2018,4744,Male,Sarawak,16,8,10,1,35,40,75,B
2015,4745,Female,Negeri Sembilan,14,3,3,1,21,36,57,C
2012,4746,Female,Perak,18,5,5,1,29,22,51,C
2013,4747,Female,Terengganu,19,3,4,5,31,40,71,B
2015,4748,Female,Pahang,17,10,10,4,41,30,71,B
2012,4749,Male,Negeri Sembilan,16,3,6,4,29,23,52,C
2013,4750,Male,Negeri Sembilan,21,3,3,4,31,25,56,C
2019,4751,Female,Terengganu,16,7,5,3,31,22,53,C
2014,4752,Female,Kelantan,21,7,6,1,35,35,70,B
2017,4753,Female,Malacca,19,4,5,3,31,36,67,B
2018,4754,Male,Malacca,14,7,3,5,29,39,68,B
2012,4755,Male,Negeri Sembilan,15,3,4,2,24,24,48,F
2015,4756,Female,Terengganu,16,8,4,4,32,32,64,B
2017,4757,Male,Johor,14,5,10,3,32,27,59,C
2019,4758,Male,Perlis,19,6,7,3,35,38,73,B
2016,4759,Female,Perak,17,5,7,3,32,39,71,B
2018,4760,Female,Terengganu,17,8,8,4,37,34,71,B
2015,4761,Male,Penang,15,7,8,2,32,28,60,B
2017,4762,Female,Malacca,15,4,4,3,26,24,50,C
2019,4763,Male,Penang,15,5,4,2,26,37,63,B
2017,4764,Female,Kedah,18,10,8,2,38,28,66,B
2017,4765,Male,Terengganu,18,8,3,2,31,37,68,B
2016,4766,Male,Sarawak,19,6,9,5,39,40,79,A
2013,4767,Female,Pahang,15,7,5,4,31,30,61,B
2013,4768,Female,Terengganu,15,3,3,4,25,38,63,B
2017,4769,Male,Pahang,14,6,6,2,28,22,50,C
2012,4770,Male,Penang,19,10,8,5,42,25,67,B
2019,4771,Male,Penang,16,9,5,1,31,38,69,B
2019,4772,Male,Selangor,16,6,9,2,33,35,68,B
2012,4773,Female,Terengganu,14,7,7,5,33,37,70,B
2018,4774,Female,Perak,20,8,7,4,39,40,79,A
2018,4775,Male,Terengganu,16,10,8,1,35,26,61,B
2018,4776,Male,Negeri Sembilan,16,4,9,4,33,40,73,B
2012,4777,Male,Kelantan,21,3,3,5,32,26,58,C
2016,4778,Female,Penang,18,8,3,2,31,37,68,B
2015,4779,Female,Sarawak,15,3,4,3,25,32,57,C
2016,4780,Female,Sarawak,18,7,8,2,35,29,64,B
2019,4781,Male,Selangor,21,7,10,3,41,40,81,A
2015,4782,Female,Sarawak,13,7,9,5,34,37,71,B
2016,4783,Male,Negeri Sembilan,20,8,10,5,43,28,71,B
2017,4784,Male,Kedah,16,6,9,2,33,26,59,C
2018,4785,Female,Terengganu,18,7,8,1,34,29,63,B
2018,4786,Female,Kedah,21,6,5,5,37,30,67,B
2012,4787,Female,Terengganu,16,10,10,1,37,34,71,B
2019,4788,Male,Sarawak,21,10,5,3,39,26,65,B
2012,4789,Male,Perak,16,5,9,4,34,32,66,B
2012,4790,Female,Sarawak,13,7,6,4,30,36,66,B
2019,4791,Female,Kedah,15,3,10,5,33,35,68,B
2014,4792,Male,Kelantan,18,6,7,2,33,27,60,B
2013,4793,Male,Johor,16,6,6,2,30,36,66,B
2014,4794,Male,Perak,16,5,9,1,31,22,53,C
2018,4795,Male,Pahang,16,5,10,5,36,40,76,B
2018,4796,Female,Perak,16,3,4,5,28,33,61,B
2018,4797,Female,Perlis,21,6,9,3,39,26,65,B
2018,4798,Female,Sarawak,21,3,8,1,33,23,56,C
2019,4799,Male,Perak,19,3,8,1,31,28,59,C
2016,4800,Male,Pahang,21,6,7,3,37,39,76,B
2013,4801,Female,Sarawak,14,7,4,5,30,32,62,B
2019,4802,Female,Pahang,18,4,5,1,28,38,66,B
2016,4803,Male,Penang,18,4,5,5,32,35,67,B
2014,4804,Male,Negeri Sembilan,21,8,7,5,41,32,73,B
2012,4805,Female,Johor,18,6,8,3,35,27,62,B
2019,4806,Male,Johor,21,7,5,5,38,38,76,B
2017,4807,Male,Kedah,14,8,5,2,29,33,62,B
2015,4808,Male,Pahang,18,6,3,3,30,32,62,B
2017,4809,Female,Sarawak,20,6,6,5,37,25,62,B
2017,4810,Male,Malacca,13,4,10,5,32,29,61,B
2013,4811,Male,Perlis,17,8,6,2,33,34,67,B
2016,4812,Male,Terengganu,19,5,9,3,36,24,60,B
2018,4813,Female,Pahang,19,10,8,5,42,35,77,B
2012,4814,Male,Negeri Sembilan,14,4,4,5,27,26,53,C
2015,4815,Male,Kelantan,18,4,10,2,34,29,63,B
2016,4816,Male,Kedah,20,4,10,5,39,33,72,B
2019,4817,Female,Sabah,17,9,5,2,33,39,72,B
2018,4818,Female,Negeri Sembilan,15,4,5,2,26,36,62,B
2012,4819,Female,Terengganu,19,4,10,2,35,31,66,B
2018,4820,Male,Sarawak,21,10,4,2,37,31,68,B
2019,4821,Female,Negeri Sembilan,15,5,6,3,29,40,69,B
2019,4822,Male,Selangor,18,4,7,4,33,27,60,B
2016,4823,Female,Perlis,17,10,3,2,32,31,63,B
2014,4824,Female,Malacca,20,4,9,4,37,33,70,B
2017,4825,Male,Penang,16,7,9,5,37,40,77,B
2013,4826,Female,Malacca,17,5,6,4,32,36,68,B
2013,4827,Male,Malacca,15,7,10,2,34,33,67,B
2012,4828,Male,Terengganu,17,7,9,5,38,39,77,B
2017,4829,Female,Sabah,15,8,6,5,34,39,73,B
2014,4830,Male,Johor,17,8,9,2,36,30,66,B
2014,4831,Male,Penang,17,4,3,3,27,28,55,C
2014,4832,Male,Sabah,20,9,3,4,36,28,64,B
2014,4833,Female,Terengganu,13,10,7,3,33,40,73,B
2015,4834,Female,Terengganu,20,8,10,5,43,37,80,A
2018,4835,Male,Johor,15,6,4,5,30,37,67,B
2014,4836,Female,Negeri Sembilan,21,8,7,2,38,22,60,B
2016,4837,Female,Negeri Sembilan,17,5,5,1,28,34,62,B
2015,4838,Male,Kelantan,15,8,3,5,31,36,67,B
2015,4839,Male,Perak,19,4,9,2,34,31,65,B
2018,4840,Female,Johor,21,5,9,1,36,29,65,B
2016,4841,Male,Johor,13,8,8,2,31,28,59,C
2017,4842,Female,Terengganu,15,4,8,4,31,31,62,B
2013,4843,Male,Kedah,21,9,10,4,44,28,72,B
2018,4844,Male,Perlis,19,7,6,2,34,27,61,B
2012,4845,Male,Sarawak,21,4,5,2,32,32,64,B
2013,4846,Male,Terengganu,20,6,6,4,36,37,73,B
2014,4847,Male,Sabah,19,4,4,4,31,38,69,B
2019,4848,Female,Sabah,21,5,4,4,34,39,73,B
2014,4849,Female,Johor,17,9,5,3,34,25,59,C
2018,4850,Male,Negeri Sembilan,17,10,5,5,37,40,77,B
2017,4851,Male,Terengganu,19,3,7,5,34,26,60,B
2016,4852,Female,Sabah,19,8,6,3,36,23,59,C
2019,4853,Female,Selangor,16,7,5,1,29,24,53,C
2018,4854,Male,Kedah,13,3,3,1,20,28,48,F
2016,4855,Male,Penang,17,8,8,5,38,40,78,B
2017,4856,Male,Penang,21,8,9,5,43,34,77,B
2015,4857,Male,Sabah,13,10,5,3,31,34,65,B
2015,4858,Male,Negeri Sembilan,17,9,10,3,39,27,66,B
2017,4859,Female,Sabah,17,5,9,1,32,34,66,B
2018,4860,Female,Johor,15,4,3,4,26,22,48,F
2015,4861,Female,Negeri Sembilan,20,8,9,2,39,40,79,A
2018,4862,Male,Terengganu,17,8,6,2,33,35,68,B
2018,4863,Male,Sabah,18,5,6,1,30,26,56,C
2016,4864,Male,Pahang,20,7,8,5,40,35,75,B
2017,4865,Male,Sabah,19,4,5,5,33,36,69,B
2019,4866,Female,Negeri Sembilan,19,5,5,2,31,34,65,B
2013,4867,Female,Negeri Sembilan,18,5,3,3,29,38,67,B
2019,4868,Female,Negeri Sembilan,19,10,9,3,41,36,77,B
2015,4869,Female,Sabah,20,5,8,5,38,38,76,B
2016,4870,Female,Selangor,16,7,4,3,30,32,62,B
2014,4871,Male,Kedah,20,4,6,5,35,29,64,B
2013,4872,Female,Perak,21,8,6,5,40,32,72,B
2014,4873,Male,Perlis,19,5,4,1,29,26,55,C
2017,4874,Female,Malacca,18,4,10,1,33,39,72,B
2016,4875,Female,Kelantan,17,7,6,2,32,37,69,B
2015,4876,Female,Sabah,17,3,9,3,32,27,59,C
2017,4877,Male,Selangor,19,6,8,1,34,29,63,B
2019,4878,Female,Perak,13,8,10,1,32,35,67,B
2013,4879,Male,Perlis,14,9,6,4,33,32,65,B
2018,4880,Male,Terengganu,18,4,4,1,27,24,51,C
2015,4881,Male,Penang,17,5,9,3,34,37,71,B
2013,4882,Male,Selangor,15,10,10,3,38,37,75,B
2015,4883,Female,Kelantan,19,10,7,2,38,23,61,B
2015,4884,Male,Johor,17,10,4,1,32,23,55,C
2017,4885,Male,Terengganu,16,4,4,3,27,39,66,B
2016,4886,Male,Terengganu,19,7,4,5,35,30,65,B
2014,4887,Female,Kedah,21,8,4,5,38,35,73,B
2012,4888,Female,Kedah,13,4,10,4,31,32,63,B
2018,4889,Female,Malacca,13,4,5,1,23,23,46,F
2013,4890,Female,Sarawak,17,5,5,5,32,29,61,B
2012,4891,Male,Sarawak,15,5,6,3,29,25,54,C
2014,4892,Female,Pahang,19,7,10,3,39,33,72,B
2013,4893,Male,Sarawak,14,4,4,4,26,36,62,B
2018,4894,Female,Johor,14,8,6,1,29,33,62,B
2016,4895,Female,Malacca,21,9,5,3,38,30,68,B
2014,4896,Male,Sarawak,16,6,5,1,28,26,54,C
2017,4897,Female,Selangor,14,5,9,4,32,39,71,B
2019,4898,Female,Sarawak,21,4,5,5,35,29,64,B
2016,4899,Male,Pahang,20,4,5,5,34,30,64,B
2014,4900,Male,Terengganu,17,8,8,3,36,23,59,C
2012,4901,Male,Perak,17,5,8,1,31,37,68,B
2014,4902,Male,Perak,16,3,3,5,27,31,58,C
2013,4903,Female,Sarawak,14,9,9,2,34,27,61,B
2015,4904,Female,Negeri Sembilan,19,8,5,1,33,35,68,B
2013,4905,Female,Penang,15,4,4,4,27,29,56,C
2014,4906,Female,Kedah,14,7,7,1,29,23,52,C
2015,4907,Female,Malacca,13,7,6,5,31,36,67,B
2016,4908,Female,Kedah,16,9,5,1,31,36,67,B
2017,4909,Male,Selangor,13,4,6,3,26,33,59,C
2014,4910,Male,Johor,18,8,3,1,30,25,55,C
2018,4911,Male,Perak,13,3,6,1,23,26,49,F
2016,4912,Male,Johor,19,10,6,4,39,31,70,B
2017,4913,Female,Sarawak,15,4,10,2,31,31,62,B
2018,4914,Female,Malacca,14,10,9,1,34,39,73,B
2013,4915,Male,Kelantan,13,9,7,2,31,32,63,B
2013,4916,Female,Perak,14,10,3,2,29,33,62,B
2013,4917,Female,Perlis,16,7,7,2,32,39,71,B
2017,4918,Female,Sarawak,15,5,9,4,33,38,71,B
2014,4919,Male,Negeri Sembilan,13,10,3,3,29,30,59,C
2017,4920,Male,Pahang,14,8,7,5,34,28,62,B
2019,4921,Male,Selangor,21,4,3,4,32,35,67,B
2016,4922,Male,Selangor,16,7,5,1,29,29,58,C
2017,4923,Male,Sabah,15,4,7,4,30,37,67,B
2013,4924,Female,Penang,14,6,8,2,30,23,53,C
2013,4925,Female,Negeri Sembilan,20,6,5,4,35,24,59,C
2016,4926,Male,Sarawak,13,7,4,5,29,38,67,B
2018,4927,Male,Sarawak,13,3,10,5,31,37,68,B
2015,4928,Male,Perlis,18,9,3,3,33,39,72,B
2014,4929,Female,Kedah,21,6,9,1,37,25,62,B
2017,4930,Male,Terengganu,13,6,5,1,25,28,53,C
2012,4931,Male,Pahang,19,4,5,4,32,31,63,B
2012,4932,Male,Terengganu,13,7,4,5,29,31,60,B
2013,4933,Female,Negeri Sembilan,19,3,7,5,34,29,63,B
2014,4934,Female,Kelantan,14,7,7,2,30,37,67,B
2017,4935,Male,Pahang,14,8,7,4,33,40,73,B
2012,4936,Male,Perlis,15,8,3,3,29,30,59,C
2017,4937,Male,Terengganu,16,9,6,4,35,24,59,C
2012,4938,Male,Negeri Sembilan,15,4,10,5,34,35,69,B
2019,4939,Female,Terengganu,18,7,3,2,30,34,64,B
2015,4940,Male,Penang,14,3,7,2,26,26,52,C
2015,4941,Male,Perak,14,5,5,4,28,23,51,C
2016,4942,Female,Sarawak,16,5,5,3,29,26,55,C
2015,4943,Male,Kedah,14,7,3,1,25,36,61,B
2018,4944,Female,Perlis,16,4,7,3,30,38,68,B
2019,4945,Male,Sabah,14,4,7,1,26,34,60,B
2013,4946,Female,Perlis,15,3,3,5,26,28,54,C
2019,4947,Male,Sarawak,21,9,9,1,40,28,68,B
2018,4948,Male,Sarawak,13,7,5,2,27,39,66,B
2019,4949,Male,Negeri Sembilan,16,5,7,5,33,28,61,B
2017,4950,Female,Negeri Sembilan,15,3,7,3,28,38,66,B
2013,4951,Female,Kedah,13,10,9,1,33,32,65,B
2014,4952,Male,Sabah,19,7,9,1,36,23,59,C
2015,4953,Male,Kelantan,20,3,7,5,35,26,61,B
2015,4954,Male,Perak,14,6,7,3,30,40,70,B
2015,4955,Female,Pahang,13,10,7,4,34,32,66,B
2016,4956,Male,Malacca,19,5,7,1,32,28,60,B
2013,4957,Female,Pahang,21,8,3,5,37,38,75,B
2013,4958,Female,Johor,21,4,6,4,35,22,57,C
2015,4959,Female,Penang,13,4,7,2,26,24,50,C
2015,4960,Male,Malacca,19,5,5,3,32,28,60,B
2015,4961,Male,Sabah,18,3,10,1,32,27,59,C
2018,4962,Female,Kelantan,20,5,7,5,37,24,61,B
2019,4963,Female,Kedah,20,8,6,2,36,38,74,B
2015,4964,Male,Perak,17,8,6,3,34,22,56,C
2015,4965,Male,Selangor,21,8,5,5,39,25,64,B
2014,4966,Male,Johor,21,3,6,3,33,27,60,B
2018,4967,Male,Terengganu,14,6,10,4,34,39,73,B
2014,4968,Female,Selangor,15,7,4,3,29,32,61,B
2019,4969,Male,Johor,15,5,6,3,29,29,58,C
2018,4970,Male,Pahang,20,5,6,1,32,26,58,C
2013,4971,Male,Malacca,21,10,7,3,41,30,71,B
2016,4972,Female,Johor,13,10,3,1,27,22,49,F
2016,4973,Male,Pahang,17,6,10,1,34,40,74,B
2013,4974,Male,Perak,15,10,3,1,29,23,52,C
2019,4975,Female,Kelantan,14,6,7,5,32,26,58,C
2015,4976,Female,Sabah,19,3,9,3,34,29,63,B
2016,4977,Male,Sarawak,19,5,5,4,33,30,63,B
2019,4978,Male,Perlis,19,9,7,5,40,32,72,B
2018,4979,Female,Perak,16,7,9,2,34,39,73,B
2012,4980,Male,Sabah,18,9,7,4,38,25,63,B
2016,4981,Female,Selangor,15,4,5,4,28,40,68,B
2018,4982,Female,Terengganu,17,8,4,4,33,28,61,B
2016,4983,Female,Kelantan,17,7,8,4,36,29,65,B
2016,4984,Female,Negeri Sembilan,21,3,8,3,35,30,65,B
2019,4985,Female,Kedah,13,6,5,5,29,38,67,B
2015,4986,Female,Kelantan,21,7,5,2,35,23,58,C
2018,4987,Male,Kedah,14,8,5,4,31,23,54,C
2014,4988,Female,Kedah,14,5,4,2,25,31,56,C
2016,4989,Male,Kelantan,13,8,8,5,34,35,69,B
2013,4990,Male,Kedah,21,9,3,1,34,25,59,C
2013,4991,Female,Penang,16,9,4,3,32,23,55,C
2016,4992,Male,Penang,19,10,10,4,43,34,77,B
2019,4993,Female,Penang,20,5,5,2,32,26,58,C
2016,4994,Male,Perlis,20,7,10,3,40,24,64,B
2014,4995,Male,Perlis,16,6,10,3,35,26,61,B
2016,4996,Male,Sarawak,15,3,7,2,27,36,63,B
2013,4997,Male,Perlis,13,5,4,1,23,28,51,C
2016,4998,Female,Negeri Sembilan,15,8,9,5,37,35,72,B
2018,4999,Female,Sarawak,19,7,4,4,34,25,59,C
2019,5000,Male,Terengganu,18,7,4,4,33,22,55,C
2019,5001,Male,Johor,18,8,4,4,34,35,69,B
2015,5002,Male,Pahang,16,3,9,5,33,26,59,C
2014,5003,Male,Kedah,16,3,4,3,26,32,58,C
2014,5004,Female,Perak,19,5,9,4,37,31,68,B
2018,5005,Female,Kedah,13,9,5,4,31,31,62,B
2013,5006,Male,Sabah,21,8,5,3,37,23,60,B
2015,5007,Female,Negeri Sembilan,18,5,4,1,28,33,61,B
2018,5008,Male,Malacca,13,4,8,3,28,36,64,B
2015,5009,Female,Kedah,17,7,3,5,32,30,62,B
2015,5010,Female,Perak,14,4,9,2,29,37,66,B
2014,5011,Male,Penang,15,9,10,1,35,27,62,B
2013,5012,Female,Sarawak,20,8,3,5,36,34,70,B
2017,5013,Male,Johor,13,6,5,4,28,33,61,B
2015,5014,Male,Penang,16,7,5,4,32,32,64,B
2016,5015,Male,Malacca,16,5,3,2,26,39,65,B
2013,5016,Female,Negeri Sembilan,20,4,7,2,33,28,61,B
2016,5017,Male,Malacca,21,5,8,2,36,28,64,B
2013,5018,Male,Terengganu,17,4,3,4,28,37,65,B
2013,5019,Female,Perlis,15,6,3,3,27,34,61,B
2017,5020,Male,Negeri Sembilan,15,8,3,2,28,28,56,C
2014,5021,Female,Sarawak,21,6,10,4,41,31,72,B
2019,5022,Female,Penang,17,9,4,3,33,33,66,B
2019,5023,Male,Penang,20,10,6,2,38,33,71,B
2015,5024,Female,Johor,18,10,3,2,33,24,57,C
2013,5025,Male,Sabah,13,4,7,2,26,26,52,C
2013,5026,Male,Sabah,13,3,8,4,28,33,61,B
2014,5027,Male,Kelantan,14,5,3,2,24,38,62,B
2019,5028,Male,Sabah,20,9,9,1,39,27,66,B
2017,5029,Female,Negeri Sembilan,18,10,5,2,35,33,68,B
2016,5030,Female,Terengganu,20,7,10,2,39,29,68,B
2012,5031,Female,Sarawak,20,8,9,5,42,30,72,B
2018,5032,Female,Negeri Sembilan,21,10,7,5,43,27,70,B
2014,5033,Female,Pahang,18,6,3,3,30,33,63,B
2015,5034,Female,Pahang,14,4,5,5,28,30,58,C
2014,5035,Male,Johor,15,4,9,4,32,31,63,B
2013,5036,Male,Perak,15,5,6,1,27,34,61,B
2015,5037,Female,Sabah,14,3,6,5,28,31,59,C
2015,5038,Female,Terengganu,16,6,8,2,32,37,69,B
2018,5039,Male,Negeri Sembilan,20,4,5,4,33,23,56,C
2015,5040,Male,Negeri Sembilan,20,7,3,3,33,31,64,B
2017,5041,Female,Kelantan,19,4,3,1,27,28,55,C
2013,5042,Female,Kedah,15,8,10,1,34,22,56,C
2015,5043,Female,Negeri Sembilan,21,7,8,2,38,36,74,B
2014,5044,Female,Kelantan,13,3,8,4,28,26,54,C
2013,5045,Male,Selangor,17,7,4,4,32,27,59,C
2017,5046,Male,Pahang,18,5,3,2,28,38,66,B
2014,5047,Male,Pahang,19,3,10,2,34,35,69,B
2014,5048,Female,Negeri Sembilan,17,4,4,3,28,28,56,C
2012,5049,Male,Pahang,20,9,3,1,33,40,73,B
2018,5050,Male,Perak,20,5,3,4,32,26,58,C
2014,5051,Female,Malacca,14,3,10,2,29,39,68,B
2015,5052,Male,Perlis,18,6,6,4,34,29,63,B
2014,5053,Female,Sarawak,21,5,6,3,35,40,75,B
2012,5054,Male,Pahang,21,4,3,3,31,22,53,C
2012,5055,Female,Negeri Sembilan,13,9,8,1,31,39,70,B
2012,5056,Female,Sabah,13,10,8,1,32,28,60,B
2016,5057,Female,Kedah,18,3,4,2,27,32,59,C
2012,5058,Male,Penang,21,9,6,5,41,31,72,B
2017,5059,Female,Terengganu,17,5,8,3,33,36,69,B
2016,5060,Male,Johor,13,9,8,4,34,40,74,B
2017,5061,Female,Kelantan,18,5,6,2,31,34,65,B
2013,5062,Male,Sabah,13,10,10,4,37,30,67,B
2015,5063,Male,Negeri Sembilan,21,5,4,5,35,31,66,B
2017,5064,Female,Malacca,16,9,8,1,34,29,63,B
2012,5065,Female,Pahang,19,5,10,4,38,39,77,B
2017,5066,Male,Penang,19,3,8,1,31,30,61,B
2012,5067,Female,Malacca,16,8,4,3,31,34,65,B
2012,5068,Female,Selangor,21,9,8,3,41,32,73,B
2014,5069,Female,Sarawak,19,8,10,5,42,27,69,B
2019,5070,Female,Kedah,17,10,5,3,35,30,65,B
2013,5071,Male,Johor,18,8,6,1,33,27,60,B
2012,5072,Female,Selangor,18,7,10,1,36,30,66,B
2012,5073,Female,Penang,18,4,10,5,37,28,65,B
2019,5074,Female,Sarawak,18,4,5,2,29,24,53,C
2016,5075,Male,Sabah,14,4,4,5,27,30,57,C
2015,5076,Male,Negeri Sembilan,19,6,8,3,36,30,66,B
2015,5077,Female,Penang,13,3,10,5,31,37,68,B
2013,5078,Male,Malacca,20,8,9,2,39,39,78,B
2019,5079,Male,Perak,21,4,6,1,32,24,56,C
2013,5080,Female,Terengganu,13,8,10,5,36,39,75,B
2018,5081,Male,Penang,18,6,3,4,31,27,58,C
2016,5082,Female,Malacca,15,5,10,2,32,40,72,B
2019,5083,Female,Kedah,15,5,5,3,28,40,68,B
2014,5084,Female,Malacca,18,10,9,1,38,37,75,B
2012,5085,Male,Kelantan,14,3,8,3,28,37,65,B
2016,5086,Male,Terengganu,15,4,5,4,28,40,68,B
2016,5087,Female,Terengganu,15,8,4,2,29,23,52,C
2014,5088,Female,Kedah,21,7,10,4,42,40,82,A
2017,5089,Female,Terengganu,20,6,6,5,37,36,73,B
2016,5090,Male,Kelantan,15,3,8,4,30,37,67,B
2014,5091,Female,Terengganu,16,7,4,4,31,31,62,B
2019,5092,Male,Malacca,20,6,5,3,34,30,64,B
2019,5093,Male,Pahang,16,8,6,4,34,30,64,B
2016,5094,Male,Kedah,13,6,5,3,27,39,66,B
2016,5095,Female,Malacca,16,5,9,3,33,36,69,B
2015,5096,Female,Selangor,16,5,5,3,29,29,58,C
2015,5097,Female,Perak,13,3,4,2,22,38,60,B
2016,5098,Female,Johor,18,10,6,1,35,22,57,C
2015,5099,Female,Sabah,14,3,7,1,25,36,61,B
2018,5100,Female,Sarawak,17,8,10,5,40,24,64,B
2018,5101,Male,Sabah,21,4,10,3,38,33,71,B
2014,5102,Female,Perlis,14,4,7,5,30,29,59,C
2014,5103,Male,Penang,18,7,10,2,37,23,60,B
2016,5104,Female,Sarawak,17,8,3,1,29,36,65,B
2016,5105,Female,Negeri Sembilan,21,9,4,1,35,26,61,B
2019,5106,Male,Negeri Sembilan,20,8,9,2,39,31,70,B
2016,5107,Male,Johor,16,5,3,1,25,33,58,C
2019,5108,Male,Selangor,13,5,3,4,25,39,64,B
2012,5109,Male,Sarawak,15,9,9,2,35,24,59,C
2019,5110,Female,Selangor,19,6,4,5,34,40,74,B
2015,5111,Female,Perlis,20,4,4,5,33,32,65,B
2013,5112,Male,Sarawak,19,5,8,3,35,37,72,B
2018,5113,Female,Pahang,19,10,9,3,41,40,81,A
2018,5114,Female,Malacca,19,5,3,2,29,25,54,C
2014,5115,Female,Perlis,16,5,8,1,30,35,65,B
2013,5116,Male,Sabah,18,5,4,4,31,31,62,B
2019,5117,Male,Johor,13,4,5,1,23,38,61,B
2019,5118,Male,Sabah,16,8,9,5,38,27,65,B
2014,5119,Male,Negeri Sembilan,20,6,5,3,34,37,71,B
2012,5120,Male,Kelantan,20,6,7,1,34,26,60,B
2014,5121,Male,Terengganu,19,5,6,3,33,22,55,C
2012,5122,Female,Negeri Sembilan,18,5,4,2,29,25,54,C
2012,5123,Male,Selangor,21,10,7,5,43,35,78,B
2017,5124,Male,Negeri Sembilan,13,9,10,1,33,28,61,B
2012,5125,Male,Perlis,13,5,9,5,32,39,71,B
2013,5126,Male,Perlis,16,6,8,3,33,39,72,B
2018,5127,Female,Pahang,19,3,5,3,30,30,60,B
2012,5128,Male,Johor,19,4,7,1,31,25,56,C
2016,5129,Female,Kedah,21,10,8,4,43,39,82,A
2015,5130,Male,Perak,16,5,5,2,28,34,62,B
2016,5131,Male,Pahang,20,9,8,5,42,38,80,A
2019,5132,Female,Kelantan,21,8,3,4,36,39,75,B
2014,5133,Female,Perlis,18,4,3,5,30,22,52,C
2018,5134,Female,Penang,19,8,4,4,35,29,64,B
2016,5135,Male,Johor,20,5,5,4,34,31,65,B
2012,5136,Female,Penang,13,8,4,5,30,27,57,C
2019,5137,Male,Penang,20,9,10,2,41,34,75,B
2017,5138,Female,Kedah,13,8,10,4,35,40,75,B
2017,5139,Male,Negeri Sembilan,14,10,3,1,28,31,59,C
2016,5140,Female,Perlis,15,7,8,2,32,29,61,B
2014,5141,Male,Perak,19,10,8,5,42,26,68,B
2016,5142,Female,Pahang,13,5,10,4,32,28,60,B
2018,5143,Female,Johor,18,4,6,2,30,24,54,C
2015,5144,Male,Perak,13,7,9,2,31,38,69,B
2012,5145,Female,Sabah,21,5,3,2,31,37,68,B
2012,5146,Male,Negeri Sembilan,13,8,4,2,27,39,66,B
2012,5147,Male,Perak,20,6,4,1,31,35,66,B
2014,5148,Female,Negeri Sembilan,16,6,8,1,31,37,68,B
2015,5149,Male,Selangor,20,9,7,5,41,39,80,A
2015,5150,Male,Kelantan,20,7,6,5,38,37,75,B
2015,5151,Male,Selangor,21,9,4,5,39,37,76,B
2017,5152,Female,Sabah,15,7,5,2,29,27,56,C
2014,5153,Male,Kelantan,13,3,8,2,26,25,51,C
2017,5154,Male,Pahang,14,5,7,3,29,22,51,C
2017,5155,Female,Sabah,15,10,7,1,33,24,57,C
2013,5156,Male,Malacca,17,8,3,3,31,28,59,C
2017,5157,Male,Terengganu,21,7,3,4,35,33,68,B
2017,5158,Male,Perak,16,5,6,3,30,23,53,C
2015,5159,Male,Kelantan,15,6,10,3,34,26,60,B
2016,5160,Male,Malacca,19,5,7,5,36,31,67,B
2013,5161,Female,Kedah,14,5,5,3,27,38,65,B
2017,5162,Male,Pahang,18,10,7,1,36,31,67,B
2015,5163,Male,Perlis,14,8,6,4,32,27,59,C
2015,5164,Male,Johor,20,7,9,2,38,28,66,B
2015,5165,Female,Kedah,18,4,10,1,33,28,61,B
2015,5166,Female,Sabah,21,6,3,2,32,24,56,C
2013,5167,Female,Johor,16,6,8,1,31,31,62,B
2016,5168,Male,Pahang,14,8,4,1,27,24,51,C
2012,5169,Female,Penang,19,3,3,4,29,30,59,C
2016,5170,Female,Kelantan,17,4,9,4,34,38,72,B
2019,5171,Female,Terengganu,20,5,8,2,35,26,61,B
2012,5172,Female,Perlis,17,9,6,3,35,30,65,B
2012,5173,Male,Perak,21,9,3,1,34,33,67,B
2017,5174,Female,Sabah,13,6,4,4,27,30,57,C
2012,5175,Male,Sarawak,21,9,5,1,36,38,74,B
2013,5176,Male,Penang,19,3,9,3,34,27,61,B
2012,5177,Male,Perlis,13,3,6,5,27,29,56,C
2012,5178,Female,Kelantan,13,4,10,1,28,23,51,C
2014,5179,Female,Selangor,21,6,10,2,39,29,68,B
2017,5180,Female,Pahang,21,7,8,1,37,33,70,B
2018,5181,Female,Sabah,14,3,5,4,26,32,58,C
2018,5182,Male,Terengganu,14,6,5,2,27,38,65,B
2012,5183,Female,Perlis,19,7,7,5,38,23,61,B
2013,5184,Female,Kelantan,13,5,5,3,26,39,65,B
2018,5185,Female,Terengganu,21,10,8,5,44,24,68,B
2017,5186,Male,Kelantan,20,4,3,5,32,24,56,C
2015,5187,Female,Perak,17,10,3,5,35,23,58,C
2015,5188,Female,Selangor,17,8,3,4,32,31,63,B
2016,5189,Male,Sarawak,13,10,5,3,31,25,56,C
2014,5190,Male,Perlis,14,3,4,3,24,28,52,C
2015,5191,Female,Johor,13,9,5,4,31,31,62,B
2019,5192,Male,Sarawak,19,6,3,3,31,34,65,B
2018,5193,Female,Sabah,20,4,5,3,32,26,58,C
2012,5194,Female,Sarawak,21,10,4,5,40,25,65,B
2013,5195,Female,Kedah,15,6,7,5,33,30,63,B
2018,5196,Female,Kelantan,14,4,8,2,28,24,52,C
2014,5197,Male,Kelantan,20,10,5,1,36,26,62,B
2013,5198,Female,Selangor,13,4,5,5,27,30,57,C
2019,5199,Female,Sabah,14,6,10,3,33,27,60,B
2012,5200,Male,Pahang,20,10,7,1,38,24,62,B
2012,5201,Male,Kelantan,17,3,10,1,31,34,65,B
2014,5202,Female,Perlis,20,5,10,2,37,34,71,B
2013,5203,Female,Kedah,13,6,10,1,30,40,70,B
2017,5204,Female,Sarawak,21,6,10,3,40,36,76,B
2012,5205,Female,Pahang,14,7,3,3,27,39,66,B
2017,5206,Male,Kedah,13,10,8,5,36,36,72,B
2014,5207,Female,Kedah,15,4,9,4,32,32,64,B
2015,5208,Female,Kelantan,16,4,3,3,26,26,52,C
2016,5209,Male,Negeri Sembilan,19,5,5,5,34,38,72,B
2015,5210,Male,Selangor,19,5,8,2,34,27,61,B
2012,5211,Female,Pahang,21,8,10,1,40,28,68,B
2014,5212,Female,Sabah,14,7,6,2,29,31,60,B
2012,5213,Male,Kedah,15,9,7,1,32,30,62,B
2014,5214,Female,Selangor,16,10,9,1,36,29,65,B
2012,5215,Female,Selangor,13,8,5,4,30,24,54,C
2017,5216,Female,Penang,20,9,10,1,40,22,62,B
2012,5217,Female,Johor,18,6,9,3,36,39,75,B
2018,5218,Female,Perak,21,7,6,5,39,31,70,B
2014,5219,Female,Terengganu,17,4,3,5,29,31,60,B
2013,5220,Female,Kelantan,19,3,4,5,31,28,59,C
2012,5221,Male,Sabah,17,8,10,3,38,30,68,B
2015,5222,Male,Perak,14,3,6,4,27,24,51,C
2013,5223,Male,Sarawak,20,9,10,1,40,24,64,B
2015,5224,Male,Negeri Sembilan,17,9,5,4,35,30,65,B
2013,5225,Male,Johor,18,7,10,3,38,40,78,B
2016,5226,Male,Malacca,14,3,3,1,21,37,58,C
2016,5227,Female,Terengganu,17,6,6,5,34,27,61,B
2018,5228,Male,Perlis,15,10,4,1,30,22,52,C
2014,5229,Female,Perlis,16,8,5,5,34,28,62,B
2015,5230,Female,Negeri Sembilan,21,10,3,1,35,34,69,B
2015,5231,Male,Pahang,13,7,7,5,32,40,72,B
2015,5232,Female,Kelantan,17,9,8,1,35,29,64,B
2012,5233,Female,Kelantan,13,6,6,2,27,39,66,B
2012,5234,Male,Perlis,17,3,4,2,26,28,54,C
2015,5235,Female,Sabah,19,8,7,5,39,29,68,B
2015,5236,Male,Selangor,18,8,6,2,34,22,56,C
2018,5237,Female,Johor,20,8,5,4,37,39,76,B
2015,5238,Male,Perak,20,8,6,1,35,32,67,B
2016,5239,Male,Terengganu,19,5,7,1,32,31,63,B
2013,5240,Male,Perlis,14,5,8,5,32,35,67,B
2014,5241,Female,Terengganu,15,7,10,3,35,29,64,B
2014,5242,Female,Terengganu,18,5,4,4,31,26,57,C
2013,5243,Female,Kedah,16,6,7,4,33,26,59,C
2017,5244,Male,Kelantan,18,6,6,3,33,30,63,B
2014,5245,Male,Selangor,16,10,10,1,37,22,59,C
2017,5246,Male,Terengganu,14,4,9,4,31,38,69,B
2012,5247,Male,Terengganu,14,9,4,2,29,28,57,C
2012,5248,Female,Perlis,18,9,4,1,32,36,68,B
2014,5249,Male,Malacca,18,9,9,1,37,34,71,B
2013,5250,Female,Sabah,15,3,9,3,30,33,63,B
2019,5251,Male,Sarawak,17,7,8,1,33,26,59,C
2019,5252,Male,Sabah,17,7,8,5,37,30,67,B
2016,5253,Female,Sabah,13,5,6,3,27,38,65,B
2018,5254,Male,Penang,21,4,3,1,29,27,56,C
2015,5255,Male,Kedah,18,3,5,2,28,26,54,C
2018,5256,Female,Malacca,20,3,6,2,31,31,62,B
2018,5257,Female,Sabah,20,7,4,5,36,26,62,B
2018,5258,Female,Perak,16,7,8,2,33,40,73,B
2017,5259,Female,Sabah,16,6,7,5,34,37,71,B
2013,5260,Male,Negeri Sembilan,13,8,6,3,30,36,66,B
2017,5261,Male,Selangor,19,6,7,4,36,27,63,B
2017,5262,Male,Malacca,13,5,8,3,29,40,69,B
2014,5263,Male,Kelantan,15,6,3,4,28,38,66,B
2019,5264,Male,Sabah,15,5,9,4,33,36,69,B
2014,5265,Female,Kelantan,18,10,8,1,37,31,68,B
2017,5266,Male,Kedah,17,7,6,2,32,25,57,C
2018,5267,Female,Kedah,17,9,10,1,37,30,67,B
2016,5268,Female,Pahang,20,8,9,5,42,35,77,B
2018,5269,Male,Perlis,14,7,8,5,34,26,60,B
2013,5270,Female,Sabah,20,4,4,1,29,28,57,C
2019,5271,Male,Malacca,19,9,8,5,41,37,78,B
2016,5272,Male,Sabah,19,9,5,2,35,26,61,B
2016,5273,Female,Negeri Sembilan,14,8,7,2,31,31,62,B
2014,5274,Male,Selangor,16,10,8,3,37,23,60,B
2018,5275,Female,Sarawak,13,3,5,2,23,24,47,F
2013,5276,Male,Pahang,19,8,8,3,38,29,67,B
2012,5277,Male,Selangor,19,7,4,1,31,36,67,B
2013,5278,Female,Penang,13,4,8,3,28,25,53,C
2018,5279,Female,Johor,17,8,8,3,36,34,70,B
2016,5280,Male,Sarawak,21,7,10,4,42,26,68,B
2019,5281,Male,Sabah,19,8,5,2,34,30,64,B
2015,5282,Male,Malacca,20,8,10,5,43,26,69,B
2016,5283,Female,Sarawak,18,5,10,4,37,34,71,B
2015,5284,Female,Sabah,14,3,8,1,26,31,57,C
2016,5285,Female,Negeri Sembilan,15,5,4,1,25,31,56,C
2019,5286,Female,Kelantan,15,6,6,3,30,26,56,C
2014,5287,Female,Penang,16,6,7,4,33,32,65,B
2019,5288,Female,Kelantan,15,6,10,2,33,25,58,C
2016,5289,Female,Kelantan,20,10,6,3,39,38,77,B
2012,5290,Male,Malacca,15,6,5,3,29,30,59,C
2018,5291,Male,Johor,13,9,5,2,29,34,63,B
2019,5292,Female,Sarawak,17,6,5,4,32,33,65,B
2013,5293,Male,Perak,16,9,7,1,33,28,61,B
2019,5294,Female,Penang,15,6,6,5,32,37,69,B
2017,5295,Female,Penang,19,3,7,5,34,35,69,B
2019,5296,Male,Perlis,15,5,8,1,29,26,55,C
2017,5297,Female,Perak,17,8,9,5,39,23,62,B
2014,5298,Male,Terengganu,14,10,5,5,34,35,69,B
2017,5299,Female,Perlis,19,4,5,2,30,34,64,B
2014,5300,Female,Johor,17,3,4,5,29,36,65,B
2013,5301,Male,Penang,20,5,4,5,34,22,56,C
2018,5302,Female,Perlis,21,6,9,5,41,38,79,A
2015,5303,Male,Johor,15,9,6,1,31,35,66,B
2014,5304,Male,Perlis,15,5,9,1,30,33,63,B
2012,5305,Female,Perlis,16,7,7,2,32,28,60,B
2018,5306,Male,Sarawak,17,9,10,5,41,23,64,B
2015,5307,Male,Negeri Sembilan,15,9,7,3,34,31,65,B
2018,5308,Female,Malacca,16,5,3,1,25,35,60,B
2014,5309,Male,Kelantan,16,7,3,3,29,22,51,C
2012,5310,Female,Sabah,13,7,8,3,31,35,66,B
2019,5311,Male,Perlis,18,3,6,4,31,36,67,B
2012,5312,Male,Pahang,20,8,8,4,40,37,77,B
2014,5313,Male,Kelantan,20,7,8,5,40,36,76,B
2018,5314,Male,Perak,16,6,4,2,28,28,56,C
2016,5315,Male,Kelantan,18,6,4,1,29,23,52,C
2016,5316,Female,Johor,21,7,7,3,38,38,76,B
2013,5317,Female,Sarawak,17,10,6,5,38,35,73,B
2019,5318,Female,Perak,21,7,10,1,39,38,77,B
2012,5319,Female,Kelantan,16,6,10,2,34,30,64,B
2012,5320,Male,Terengganu,18,5,4,4,31,40,71,B
2013,5321,Male,Sarawak,18,9,7,5,39,27,66,B
2019,5322,Male,Selangor,17,9,8,1,35,35,70,B
2013,5323,Male,Pahang,16,4,5,2,27,23,50,C
2019,5324,Female,Sabah,16,3,6,3,28,34,62,B
2014,5325,Female,Negeri Sembilan,20,9,4,5,38,26,64,B
2013,5326,Male,Malacca,19,5,7,3,34,26,60,B
2017,5327,Female,Kelantan,19,9,3,3,34,31,65,B
2017,5328,Male,Penang,21,4,9,2,36,24,60,B
2013,5329,Female,Terengganu,21,8,6,4,39,33,72,B
2013,5330,Female,Kelantan,17,7,6,3,33,24,57,C
2014,5331,Male,Penang,15,9,5,3,32,34,66,B
2013,5332,Male,Perak,19,10,5,1,35,27,62,B
2015,5333,Male,Selangor,15,10,10,4,39,37,76,B
2013,5334,Female,Kelantan,18,10,8,2,38,39,77,B
2018,5335,Female,Kelantan,16,7,4,4,31,32,63,B
2018,5336,Male,Malacca,14,9,5,2,30,37,67,B
2019,5337,Female,Perak,13,9,4,1,27,22,49,F
2014,5338,Female,Perlis,20,5,6,1,32,34,66,B
2017,5339,Female,Malacca,18,6,6,2,32,23,55,C
2017,5340,Male,Kedah,13,6,7,5,31,37,68,B
2012,5341,Female,Negeri Sembilan,13,8,4,2,27,38,65,B
2015,5342,Male,Negeri Sembilan,13,9,9,2,33,31,64,B
2012,5343,Female,Selangor,20,3,5,5,33,24,57,C
2016,5344,Female,Kelantan,13,8,3,4,28,30,58,C
2014,5345,Female,Perlis,13,9,3,4,29,40,69,B
2015,5346,Female,Perak,13,8,7,1,29,25,54,C
2013,5347,Male,Johor,18,9,6,1,34,27,61,B
2012,5348,Male,Perak,17,4,4,4,29,26,55,C
2012,5349,Male,Johor,17,10,10,1,38,31,69,B
2019,5350,Female,Negeri Sembilan,14,3,3,1,21,39,60,B
2018,5351,Male,Perak,21,5,6,2,34,34,68,B
2019,5352,Male,Sabah,18,6,3,4,31,22,53,C
2014,5353,Male,Malacca,17,4,4,2,27,24,51,C
2012,5354,Male,Kelantan,15,4,10,2,31,26,57,C
2013,5355,Male,Kedah,13,5,4,1,23,31,54,C
2014,5356,Male,Perlis,20,3,7,5,35,26,61,B
2018,5357,Male,Kelantan,20,6,5,5,36,37,73,B
2017,5358,Female,Sabah,13,10,5,2,30,27,57,C
2014,5359,Male,Pahang,17,10,6,4,37,36,73,B
2013,5360,Male,Perlis,17,3,3,4,27,33,60,B
2014,5361,Male,Pahang,15,7,6,2,30,23,53,C
2018,5362,Male,Negeri Sembilan,16,4,8,5,33,39,72,B
2013,5363,Male,Sarawak,16,7,8,3,34,35,69,B
2016,5364,Male,Selangor,16,7,3,5,31,30,61,B
2018,5365,Female,Sabah,13,5,9,4,31,29,60,B
2019,5366,Female,Johor,18,7,3,2,30,33,63,B
2014,5367,Female,Sarawak,20,6,3,2,31,26,57,C
2015,5368,Male,Sarawak,15,4,6,3,28,39,67,B
2018,5369,Female,Sarawak,15,10,3,1,29,30,59,C
2013,5370,Male,Terengganu,15,7,6,4,32,40,72,B
2013,5371,Male,Terengganu,15,3,10,1,29,34,63,B
2017,5372,Male,Malacca,15,5,9,1,30,37,67,B
2018,5373,Female,Terengganu,19,5,5,1,30,32,62,B
2017,5374,Male,Terengganu,17,3,10,1,31,26,57,C
2016,5375,Female,Terengganu,20,8,5,1,34,34,68,B
2012,5376,Female,Kedah,17,8,9,3,37,23,60,B
2019,5377,Male,Sarawak,14,3,5,2,24,27,51,C
2015,5378,Female,Negeri Sembilan,13,7,8,1,29,26,55,C
2012,5379,Male,Sabah,18,5,3,5,31,34,65,B
2013,5380,Male,Terengganu,15,10,3,2,30,26,56,C
2012,5381,Male,Terengganu,20,5,4,2,31,24,55,C
2019,5382,Male,Sarawak,14,4,10,3,31,28,59,C
2015,5383,Female,Sabah,20,5,10,2,37,27,64,B
2012,5384,Male,Penang,15,5,9,3,32,38,70,B
2014,5385,Male,Kelantan,18,5,8,3,34,28,62,B
2018,5386,Female,Kelantan,20,9,9,5,43,25,68,B
2018,5387,Male,Negeri Sembilan,13,9,5,4,31,35,66,B
2015,5388,Female,Selangor,20,6,7,3,36,29,65,B
2015,5389,Female,Sarawak,18,10,3,4,35,31,66,B
2018,5390,Male,Selangor,19,5,9,1,34,23,57,C
2014,5391,Female,Pahang,17,4,3,2,26,35,61,B
2018,5392,Female,Kelantan,17,6,8,1,32,28,60,B
2012,5393,Male,Johor,19,8,6,1,34,33,67,B
2014,5394,Male,Johor,16,9,7,5,37,39,76,B
2012,5395,Male,Malacca,20,9,3,2,34,37,71,B
2014,5396,Male,Penang,21,3,5,4,33,39,72,B
2016,5397,Female,Sarawak,15,9,5,5,34,36,70,B
2015,5398,Female,Pahang,18,9,10,3,40,36,76,B
2019,5399,Female,Penang,20,8,3,2,33,37,70,B
2014,5400,Female,Perlis,21,8,6,2,37,38,75,B
2013,5401,Female,Selangor,20,7,6,4,37,32,69,B
2015,5402,Male,Kelantan,20,6,5,4,35,37,72,B
2015,5403,Male,Sarawak,21,6,7,3,37,22,59,C
2012,5404,Female,Pahang,20,8,5,5,38,24,62,B
2014,5405,Female,Terengganu,14,8,10,2,34,35,69,B
2017,5406,Female,Johor,13,7,3,1,24,35,59,C
2016,5407,Female,Perak,13,9,8,4,34,24,58,C
2016,5408,Female,Negeri Sembilan,16,6,5,4,31,22,53,C
2015,5409,Male,Kelantan,17,4,7,2,30,25,55,C
2018,5410,Male,Malacca,21,7,6,4,38,32,70,B
2018,5411,Female,Sarawak,20,4,3,2,29,27,56,C
2015,5412,Male,Sabah,14,4,3,4,25,39,64,B
2013,5413,Male,Terengganu,14,4,3,2,23,39,62,B
2016,5414,Male,Perak,17,9,9,5,40,32,72,B
2017,5415,Female,Penang,16,4,7,5,32,31,63,B
2017,5416,Male,Perlis,19,10,7,2,38,30,68,B
2013,5417,Female,Perlis,20,10,9,4,43,27,70,B
2018,5418,Female,Johor,13,10,5,1,29,35,64,B
2012,5419,Female,Terengganu,13,8,3,4,28,31,59,C
2012,5420,Female,Negeri Sembilan,13,9,8,4,34,34,68,B
2019,5421,Male,Johor,14,7,3,3,27,32,59,C
2015,5422,Male,Malacca,15,10,7,1,33,27,60,B
2013,5423,Male,Sabah,14,8,6,5,33,39,72,B
2014,5424,Female,Selangor,15,6,6,2,29,25,54,C
2016,5425,Male,Malacca,15,5,4,1,25,28,53,C
2014,5426,Female,Kelantan,18,10,4,1,33,26,59,C
2015,5427,Male,Malacca,16,3,6,2,27,26,53,C
2013,5428,Female,Selangor,15,5,7,3,30,27,57,C
2014,5429,Female,Sabah,14,4,9,1,28,34,62,B
2015,5430,Male,Kedah,21,9,10,1,41,29,70,B
2012,5431,Male,Sarawak,13,7,7,4,31,23,54,C
2013,5432,Male,Negeri Sembilan,18,6,3,5,32,25,57,C
2014,5433,Male,Negeri Sembilan,14,6,7,5,32,36,68,B
2019,5434,Male,Kelantan,21,10,10,1,42,25,67,B
2016,5435,Female,Perak,19,8,6,2,35,32,67,B
2018,5436,Female,Pahang,18,6,9,5,38,26,64,B
2016,5437,Male,Sabah,16,10,7,5,38,38,76,B
2019,5438,Male,Perak,14,5,7,1,27,23,50,C
2013,5439,Male,Perlis,18,5,4,2,29,39,68,B
2019,5440,Female,Johor,21,6,3,3,33,22,55,C
2019,5441,Female,Terengganu,15,8,10,5,38,38,76,B
2018,5442,Male,Johor,20,9,10,5,44,24,68,B
2013,5443,Male,Terengganu,15,8,6,4,33,26,59,C
2013,5444,Female,Sabah,19,4,9,4,36,38,74,B
2012,5445,Female,Kelantan,13,10,9,1,33,28,61,B
2016,5446,Female,Kelantan,19,3,8,2,32,24,56,C
2012,5447,Female,Sarawak,21,7,10,2,40,23,63,B
2016,5448,Male,Sarawak,14,10,4,3,31,37,68,B
2017,5449,Female,Terengganu,16,5,9,5,35,38,73,B
2019,5450,Female,Perak,19,6,7,2,34,26,60,B
2019,5451,Male,Perlis,17,5,7,4,33,28,61,B
2013,5452,Female,Kedah,21,5,10,4,40,22,62,B
2013,5453,Male,Negeri Sembilan,18,10,6,4,38,40,78,B
2019,5454,Female,Selangor,18,7,7,3,35,36,71,B
2014,5455,Male,Perlis,15,5,9,3,32,31,63,B
2017,5456,Male,Kedah,20,6,9,3,38,38,76,B
2012,5457,Female,Sarawak,17,4,10,4,35,31,66,B
2014,5458,Female,Perlis,15,7,4,4,30,29,59,C
2013,5459,Female,Kelantan,18,4,5,4,31,36,67,B
2013,5460,Female,Kelantan,20,3,7,1,31,40,71,B
2018,5461,Male,Negeri Sembilan,18,3,4,5,30,24,54,C
2016,5462,Male,Penang,16,10,6,4,36,26,62,B
2012,5463,Male,Terengganu,21,4,4,2,31,34,65,B
2016,5464,Male,Penang,16,5,3,3,27,33,60,B
2019,5465,Male,Penang,16,7,10,5,38,23,61,B
2018,5466,Female,Perlis,18,8,4,4,34,31,65,B
2016,5467,Female,Terengganu,20,4,6,1,31,36,67,B
2019,5468,Female,Malacca,18,7,8,2,35,23,58,C
2015,5469,Female,Negeri Sembilan,20,9,10,1,40,28,68,B
2017,5470,Male,Terengganu,20,9,5,1,35,24,59,C
2013,5471,Female,Perak,17,10,9,2,38,40,78,B
2019,5472,Male,Sarawak,16,8,7,5,36,38,74,B
2018,5473,Female,Terengganu,20,6,5,5,36,38,74,B
2016,5474,Male,Perlis,16,5,3,3,27,24,51,C
2015,5475,Female,Malacca,14,9,8,3,34,22,56,C
2014,5476,Female,Pahang,14,5,9,5,33,40,73,B
2014,5477,Female,Sabah,17,3,5,4,29,35,64,B
2017,5478,Female,Penang,14,9,7,1,31,40,71,B
2013,5479,Male,Negeri Sembilan,19,4,8,3,34,30,64,B
2019,5480,Male,Johor,15,7,6,1,29,36,65,B
2018,5481,Female,Negeri Sembilan,14,9,9,1,33,27,60,B
2015,5482,Female,Malacca,19,10,7,3,39,37,76,B
2013,5483,Male,Malacca,19,8,6,5,38,32,70,B
2017,5484,Female,Sarawak,14,3,9,1,27,24,51,C
2014,5485,Female,Kedah,15,9,8,4,36,22,58,C
2018,5486,Male,Kedah,15,4,3,1,23,40,63,B
2014,5487,Female,Perak,19,5,8,3,35,40,75,B
2017,5488,Male,Malacca,18,6,6,4,34,39,73,B
2013,5489,Female,Kedah,20,3,10,3,36,33,69,B
2012,5490,Female,Kedah,21,6,5,2,34,24,58,C
2013,5491,Female,Sarawak,21,5,10,4,40,28,68,B
2017,5492,Male,Kedah,20,10,10,1,41,39,80,A
2015,5493,Female,Kelantan,15,3,8,3,29,24,53,C
2019,5494,Male,Terengganu,16,6,5,3,30,37,67,B
2019,5495,Female,Kedah,15,4,10,2,31,24,55,C
2013,5496,Female,Sabah,18,3,9,1,31,39,70,B
2014,5497,Male,Terengganu,18,6,9,5,38,27,65,B
2013,5498,Female,Pahang,18,6,10,5,39,23,62,B
2015,5499,Male,Selangor,13,3,4,2,22,28,50,C
2019,5500,Female,Penang,14,6,8,2,30,31,61,B
2018,5501,Female,Kedah,16,10,10,5,41,37,78,B
2013,5502,Male,Perlis,17,7,9,5,38,39,77,B
2017,5503,Male,Sabah,19,6,7,4,36,35,71,B
2015,5504,Female,Kedah,14,10,9,1,34,35,69,B
2014,5505,Male,Perlis,17,6,4,1,28,25,53,C
2015,5506,Female,Selangor,18,8,6,5,37,39,76,B
2017,5507,Male,Penang,13,7,7,2,29,26,55,C
2013,5508,Female,Johor,14,7,8,2,31,37,68,B
2018,5509,Female,Malacca,16,8,7,3,34,34,68,B
2019,5510,Female,Kelantan,13,7,3,4,27,40,67,B
2017,5511,Male,Negeri Sembilan,15,7,7,3,32,34,66,B
2017,5512,Male,Sarawak,14,9,3,1,27,38,65,B
2019,5513,Female,Perlis,19,9,4,5,37,27,64,B
2015,5514,Male,Selangor,13,5,4,2,24,27,51,C
2015,5515,Female,Malacca,18,9,6,3,36,31,67,B
2013,5516,Male,Negeri Sembilan,18,7,5,2,32,32,64,B
2019,5517,Male,Kedah,18,8,3,4,33,25,58,C
2015,5518,Female,Kedah,17,3,6,5,31,35,66,B
2017,5519,Female,Kedah,14,4,3,1,22,35,57,C
2017,5520,Male,Perlis,18,8,6,1,33,28,61,B
2015,5521,Male,Sabah,15,8,4,5,32,25,57,C
2019,5522,Female,Penang,17,4,10,1,32,31,63,B
2017,5523,Female,Selangor,19,8,5,5,37,34,71,B
2014,5524,Male,Pahang,16,7,3,5,31,32,63,B
2013,5525,Female,Kelantan,18,8,4,2,32,35,67,B
2014,5526,Female,Perlis,19,3,6,3,31,22,53,C
2019,5527,Female,Kedah,18,4,7,3,32,38,70,B
2016,5528,Female,Malacca,15,5,10,1,31,23,54,C
2013,5529,Female,Pahang,13,4,6,5,28,32,60,B
2019,5530,Female,Penang,20,3,6,2,31,24,55,C
2016,5531,Female,Kedah,20,6,9,2,37,37,74,B
2013,5532,Male,Perlis,13,7,5,4,29,23,52,C
2014,5533,Male,Sarawak,14,8,10,1,33,35,68,B
2014,5534,Male,Sabah,14,6,7,1,28,31,59,C
2012,5535,Male,Perlis,20,3,8,5,36,31,67,B
2013,5536,Male,Sarawak,19,9,10,2,40,22,62,B
2014,5537,Female,Malacca,15,9,9,2,35,31,66,B
2017,5538,Female,Negeri Sembilan,13,3,9,2,27,28,55,C
2012,5539,Female,Selangor,14,9,6,5,34,28,62,B
2017,5540,Male,Malacca,20,10,7,5,42,34,76,B
2013,5541,Male,Kedah,19,7,8,4,38,32,70,B
2019,5542,Male,Perlis,21,10,3,1,35,40,75,B
2017,5543,Female,Terengganu,14,3,4,2,23,27,50,C
2019,5544,Male,Perak,16,6,9,2,33,29,62,B
2016,5545,Male,Malacca,21,9,8,4,42,25,67,B
2013,5546,Female,Sabah,16,4,7,4,31,25,56,C
2014,5547,Male,Malacca,14,10,5,2,31,38,69,B
2016,5548,Female,Sabah,15,10,4,4,33,30,63,B
2012,5549,Male,Kelantan,13,5,3,2,23,27,50,C
2014,5550,Female,Kedah,18,8,7,2,35,23,58,C
2018,5551,Female,Perak,15,9,10,4,38,36,74,B
2016,5552,Male,Terengganu,15,7,8,3,33,30,63,B
2017,5553,Female,Johor,15,5,8,5,33,40,73,B
2019,5554,Female,Sarawak,19,4,7,2,32,30,62,B
2019,5555,Female,Terengganu,18,8,6,5,37,32,69,B
2013,5556,Female,Malacca,18,10,4,4,36,26,62,B
2014,5557,Female,Penang,13,10,8,1,32,36,68,B
2012,5558,Male,Negeri Sembilan,14,9,7,5,35,22,57,C
2013,5559,Female,Terengganu,14,4,3,4,25,38,63,B
2019,5560,Female,Terengganu,17,9,6,2,34,40,74,B
2017,5561,Female,Kelantan,15,8,5,3,31,29,60,B
2018,5562,Female,Kedah,17,8,3,4,32,30,62,B
2015,5563,Male,Pahang,14,3,3,4,24,24,48,F
2017,5564,Female,Selangor,15,9,6,3,33,39,72,B
2012,5565,Male,Johor,20,10,6,1,37,40,77,B
2012,5566,Female,Negeri Sembilan,18,3,9,2,32,26,58,C
2019,5567,Male,Kelantan,21,3,5,5,34,26,60,B
2012,5568,Male,Penang,13,8,4,4,29,25,54,C
2016,5569,Female,Pahang,13,3,10,2,28,29,57,C
2016,5570,Male,Perak,15,8,4,4,31,37,68,B
2016,5571,Male,Sarawak,19,6,9,4,38,32,70,B
2013,5572,Female,Kedah,15,9,3,3,30,35,65,B
2014,5573,Female,Sabah,16,10,9,5,40,30,70,B
2014,5574,Female,Malacca,14,3,7,3,27,28,55,C
2016,5575,Male,Sabah,13,9,8,4,34,28,62,B
2013,5576,Male,Perak,13,3,8,4,28,35,63,B
2019,5577,Female,Selangor,13,4,10,3,30,38,68,B
2013,5578,Female,Kedah,16,4,5,1,26,27,53,C
2014,5579,Female,Malacca,13,5,9,3,30,29,59,C
2014,5580,Female,Perak,20,7,10,1,38,25,63,B
2014,5581,Male,Negeri Sembilan,21,5,7,4,37,30,67,B
2014,5582,Female,Penang,15,4,5,5,29,24,53,C
2012,5583,Female,Sabah,21,7,6,3,37,34,71,B
2019,5584,Female,Johor,17,9,7,3,36,40,76,B
2018,5585,Female,Negeri Sembilan,17,7,10,2,36,39,75,B
2018,5586,Male,Johor,20,8,6,5,39,36,75,B
2012,5587,Male,Johor,19,5,9,5,38,33,71,B
2014,5588,Male,Perlis,19,5,8,3,35,31,66,B
2018,5589,Male,Kelantan,16,5,10,5,36,32,68,B
2018,5590,Female,Penang,14,9,8,3,34,40,74,B
2018,5591,Male,Pahang,21,9,9,3,42,30,72,B
2014,5592,Female,Perak,17,6,7,5,35,26,61,B
2014,5593,Male,Terengganu,18,8,4,1,31,28,59,C
2017,5594,Male,Kelantan,18,7,3,4,32,26,58,C
2019,5595,Male,Terengganu,15,7,6,3,31,25,56,C
2015,5596,Female,Perlis,19,7,10,3,39,38,77,B
2013,5597,Male,Negeri Sembilan,17,5,9,2,33,22,55,C
2019,5598,Female,Sabah,14,10,6,5,35,34,69,B
2018,5599,Male,Pahang,20,10,5,1,36,26,62,B
2016,5600,Female,Johor,18,3,5,1,27,23,50,C
2015,5601,Male,Sabah,17,8,10,5,40,33,73,B
2014,5602,Female,Sabah,14,9,6,2,31,27,58,C
2017,5603,Male,Perlis,14,8,4,2,28,28,56,C
2014,5604,Female,Negeri Sembilan,18,5,3,5,31,26,57,C
2018,5605,Male,Perak,13,4,6,5,28,23,51,C
2019,5606,Female,Terengganu,13,10,6,4,33,37,70,B
2014,5607,Male,Sarawak,18,7,5,4,34,22,56,C
2018,5608,Male,Perak,19,6,5,2,32,36,68,B
2017,5609,Male,Penang,17,8,9,4,38,40,78,B
2014,5610,Female,Perak,21,10,3,2,36,22,58,C
2018,5611,Female,Sarawak,16,3,4,4,27,31,58,C
2013,5612,Male,Negeri Sembilan,16,7,10,3,36,30,66,B
2019,5613,Male,Malacca,13,5,4,2,24,37,61,B
2014,5614,Male,Penang,16,10,6,4,36,24,60,B
2019,5615,Female,Selangor,21,4,10,4,39,31,70,B
2015,5616,Male,Kelantan,16,8,7,5,36,26,62,B
2013,5617,Female,Malacca,18,6,10,1,35,34,69,B
2015,5618,Male,Negeri Sembilan,14,6,6,3,29,32,61,B
2013,5619,Female,Johor,21,6,10,4,41,22,63,B
2014,5620,Female,Malacca,17,9,9,3,38,40,78,B
2019,5621,Female,Malacca,21,9,4,5,39,28,67,B
2016,5622,Male,Penang,19,5,5,5,34,39,73,B
2018,5623,Female,Negeri Sembilan,16,10,7,2,35,40,75,B
2016,5624,Female,Kedah,14,3,5,2,24,37,61,B
2014,5625,Female,Perlis,13,9,7,5,34,40,74,B
2018,5626,Female,Kelantan,15,9,6,5,35,28,63,B
2015,5627,Female,Pahang,13,8,8,3,32,27,59,C
2013,5628,Female,Johor,16,6,6,5,33,25,58,C
2018,5629,Female,Johor,17,8,5,1,31,37,68,B
2018,5630,Female,Perlis,14,7,8,2,31,30,61,B
2016,5631,Female,Kedah,14,3,8,1,26,40,66,B
2012,5632,Female,Kedah,14,6,5,4,29,33,62,B
2017,5633,Male,Negeri Sembilan,17,7,9,1,34,23,57,C
2015,5634,Male,Sarawak,18,4,7,2,31,22,53,C
2017,5635,Female,Terengganu,15,7,9,4,35,25,60,B
2014,5636,Male,Sarawak,13,4,5,2,24,40,64,B
2018,5637,Male,Negeri Sembilan,18,8,8,5,39,39,78,B
2017,5638,Female,Penang,18,7,9,4,38,29,67,B
2013,5639,Female,Kedah,14,4,7,5,30,27,57,C
2018,5640,Female,Perak,18,8,9,5,40,23,63,B
2017,5641,Male,Terengganu,14,8,9,1,32,38,70,B
2013,5642,Male,Perak,21,8,6,1,36,24,60,B
2016,5643,Male,Kedah,16,10,6,1,33,29,62,B
2018,5644,Female,Perlis,19,7,7,5,38,38,76,B
2017,5645,Male,Sabah,19,7,10,5,41,28,69,B
2014,5646,Male,Terengganu,20,4,8,4,36,32,68,B
2017,5647,Male,Perak,17,4,3,3,27,36,63,B
2019,5648,Female,Kedah,14,10,5,4,33,35,68,B
2013,5649,Male,Perak,15,8,7,3,33,26,59,C
2013,5650,Female,Kelantan,21,3,9,1,34,26,60,B
2019,5651,Female,Terengganu,18,7,8,3,36,34,70,B
2015,5652,Female,Penang,19,5,5,1,30,34,64,B
2014,5653,Male,Penang,17,10,7,2,36,35,71,B
2016,5654,Male,Negeri Sembilan,18,3,8,1,30,39,69,B
2015,5655,Female,Malacca,14,4,7,5,30,26,56,C
2017,5656,Male,Selangor,20,4,7,2,33,30,63,B
2018,5657,Male,Johor,19,9,4,4,36,29,65,B
2018,5658,Female,Kedah,16,3,4,3,26,33,59,C
2017,5659,Male,Terengganu,21,3,9,1,34,34,68,B
2014,5660,Female,Johor,16,6,6,2,30,37,67,B
2013,5661,Male,Selangor,14,7,3,1,25,25,50,C
2017,5662,Female,Sabah,15,9,7,2,33,26,59,C
2018,5663,Male,Perak,16,10,5,3,34,26,60,B
2017,5664,Female,Johor,21,4,9,4,38,23,61,B
2016,5665,Male,Perlis,17,4,9,5,35,40,75,B
2016,5666,Male,Sabah,17,4,8,3,32,32,64,B
2015,5667,Male,Sabah,16,6,6,1,29,26,55,C
2015,5668,Female,Kedah,13,5,5,5,28,36,64,B
2018,5669,Female,Selangor,13,4,7,4,28,23,51,C
2018,5670,Female,Penang,14,9,5,2,30,23,53,C
2018,5671,Male,Terengganu,13,6,8,4,31,23,54,C
2013,5672,Male,Perlis,15,4,9,3,31,33,64,B
2017,5673,Male,Terengganu,14,8,10,5,37,38,75,B
2012,5674,Male,Terengganu,18,9,6,3,36,39,75,B
2017,5675,Female,Penang,21,9,3,4,37,30,67,B
2016,5676,Female,Selangor,15,7,9,2,33,27,60,B
2014,5677,Male,Perlis,20,8,7,4,39,28,67,B
2017,5678,Female,Selangor,16,3,5,2,26,32,58,C
2015,5679,Male,Sabah,15,6,4,1,26,35,61,B
2013,5680,Male,Negeri Sembilan,15,5,7,2,29,38,67,B
2018,5681,Male,Terengganu,14,9,9,5,37,36,73,B
2019,5682,Male,Kelantan,19,4,4,5,32,22,54,C
2012,5683,Female,Kedah,16,9,6,4,35,25,60,B
2018,5684,Female,Sabah,15,3,3,1,22,32,54,C
2016,5685,Female,Negeri Sembilan,14,3,9,3,29,38,67,B
2018,5686,Female,Perlis,20,4,9,4,37,29,66,B
2014,5687,Female,Selangor,15,3,10,3,31,36,67,B
2019,5688,Male,Pahang,19,6,7,1,33,32,65,B
2016,5689,Female,Kedah,13,10,6,3,32,22,54,C
2014,5690,Female,Malacca,17,4,4,1,26,35,61,B
2016,5691,Male,Johor,14,10,5,3,32,36,68,B
2017,5692,Female,Pahang,14,8,5,2,29,23,52,C
2014,5693,Female,Kedah,17,5,5,2,29,26,55,C
2017,5694,Female,Selangor,18,10,5,4,37,27,64,B
2019,5695,Male,Sarawak,18,5,4,4,31,25,56,C
2017,5696,Male,Pahang,17,6,5,1,29,24,53,C
2013,5697,Male,Penang,17,4,7,1,29,22,51,C
2019,5698,Female,Negeri Sembilan,17,4,10,5,36,35,71,B
2014,5699,Female,Penang,13,3,9,1,26,24,50,C
2017,5700,Female,Kelantan,17,6,7,2,32,29,61,B
2018,5701,Female,Sarawak,16,8,10,2,36,26,62,B
2019,5702,Male,Sabah,18,3,6,2,29,22,51,C
2016,5703,Male,Pahang,18,6,5,4,33,22,55,C
2019,5704,Female,Perak,20,7,10,2,39,39,78,B
2016,5705,Male,Kelantan,19,9,9,4,41,22,63,B
2019,5706,Male,Selangor,18,6,3,4,31,24,55,C
2019,5707,Male,Terengganu,19,5,7,1,32,23,55,C
2014,5708,Male,Malacca,14,3,9,4,30,25,55,C
2017,5709,Female,Malacca,21,5,3,2,31,31,62,B
2018,5710,Female,Sarawak,18,3,7,5,33,29,62,B
2012,5711,Male,Penang,15,9,5,4,33,26,59,C
2015,5712,Male,Kelantan,13,7,6,2,28,38,66,B
2019,5713,Female,Terengganu,17,8,3,4,32,35,67,B
2017,5714,Female,Sarawak,13,8,5,1,27,30,57,C
2018,5715,Female,Kelantan,17,3,5,3,28,34,62,B
2016,5716,Male,Terengganu,17,6,8,2,33,24,57,C
2017,5717,Female,Penang,18,9,5,3,35,24,59,C
2012,5718,Female,Sabah,17,8,8,4,37,22,59,C
2018,5719,Female,Johor,21,5,9,4,39,22,61,B
2017,5720,Male,Johor,13,5,9,5,32,30,62,B
2014,5721,Female,Johor,21,9,6,3,39,31,70,B
2017,5722,Male,Terengganu,13,10,6,3,32,22,54,C
2019,5723,Male,Selangor,16,8,4,3,31,27,58,C
2013,5724,Male,Sabah,16,10,8,1,35,34,69,B
2019,5725,Female,Sarawak,17,9,8,5,39,26,65,B
2015,5726,Female,Selangor,20,3,8,5,36,34,70,B
2012,5727,Female,Negeri Sembilan,14,8,5,4,31,32,63,B
2012,5728,Female,Kedah,19,7,6,4,36,31,67,B
2013,5729,Female,Sarawak,14,7,9,5,35,22,57,C
2012,5730,Female,Pahang,18,8,9,4,39,25,64,B
2018,5731,Female,Pahang,18,6,6,1,31,23,54,C
2019,5732,Female,Kelantan,17,7,7,5,36,29,65,B
2015,5733,Female,Sabah,14,7,9,4,34,35,69,B
2015,5734,Male,Sabah,17,10,9,2,38,22,60,B
2015,5735,Female,Perak,15,3,9,2,29,30,59,C
2015,5736,Male,Sabah,17,9,3,2,31,39,70,B
2015,5737,Male,Penang,14,10,10,4,38,30,68,B
2018,5738,Female,Terengganu,19,10,7,4,40,30,70,B
2018,5739,Male,Penang,15,7,10,3,35,23,58,C
2012,5740,Female,Johor,14,3,6,1,24,29,53,C
2012,5741,Male,Terengganu,13,8,3,4,28,26,54,C
2016,5742,Female,Sarawak,21,5,6,5,37,27,64,B
2013,5743,Female,Perak,18,4,10,4,36,23,59,C
2015,5744,Male,Perlis,17,4,3,4,28,40,68,B
2019,5745,Female,Sarawak,19,6,4,3,32,25,57,C
2014,5746,Male,Selangor,18,5,5,3,31,24,55,C
2015,5747,Female,Negeri Sembilan,15,9,5,3,32,38,70,B
2013,5748,Female,Perak,19,5,9,2,35,22,57,C
2016,5749,Male,Malacca,15,6,3,4,28,26,54,C
2016,5750,Male,Malacca,18,8,10,3,39,32,71,B
2019,5751,Female,Sabah,16,10,4,5,35,22,57,C
2018,5752,Female,Negeri Sembilan,16,4,8,2,30,30,60,B
2019,5753,Female,Perlis,17,7,10,3,37,33,70,B
2013,5754,Female,Kelantan,20,3,9,4,36,31,67,B
2015,5755,Female,Malacca,18,10,9,2,39,40,79,A
2013,5756,Male,Terengganu,15,9,9,2,35,29,64,B
2012,5757,Male,Johor,17,4,10,1,32,38,70,B
2016,5758,Male,Perak,20,9,5,5,39,37,76,B
2019,5759,Female,Kedah,20,4,4,4,32,37,69,B
2012,5760,Female,Sabah,14,3,4,1,22,32,54,C
2019,5761,Female,Sabah,15,4,4,4,27,31,58,C
2019,5762,Female,Sabah,14,6,7,5,32,29,61,B
2013,5763,Female,Perlis,21,10,7,1,39,26,65,B
2015,5764,Male,Penang,18,10,3,1,32,33,65,B
2012,5765,Female,Perlis,18,4,8,1,31,22,53,C
2018,5766,Male,Kelantan,14,4,7,4,29,35,64,B
2018,5767,Female,Perak,16,10,6,4,36,29,65,B
2012,5768,Female,Terengganu,18,9,10,3,40,24,64,B
2017,5769,Female,Perlis,20,8,5,4,37,23,60,B
2014,5770,Female,Pahang,14,3,3,2,22,31,53,C
2012,5771,Male,Kedah,14,7,3,5,29,31,60,B
2017,5772,Female,Selangor,19,3,5,1,28,40,68,B
2014,5773,Male,Negeri Sembilan,18,4,3,2,27,24,51,C
2016,5774,Female,Selangor,20,3,6,3,32,32,64,B
2013,5775,Female,Sarawak,17,3,10,1,31,23,54,C
2016,5776,Male,Kedah,17,8,9,3,37,37,74,B
2016,5777,Female,Selangor,17,10,6,1,34,22,56,C
2018,5778,Male,Terengganu,17,8,10,1,36,26,62,B
2012,5779,Female,Selangor,20,10,5,3,38,24,62,B
2015,5780,Male,Terengganu,17,5,7,5,34,35,69,B
2019,5781,Male,Terengganu,14,5,10,5,34,28,62,B
2016,5782,Male,Kelantan,14,8,10,3,35,30,65,B
2018,5783,Female,Perak,17,10,9,2,38,32,70,B
2012,5784,Male,Terengganu,16,7,9,5,37,38,75,B
2018,5785,Male,Terengganu,18,6,3,4,31,34,65,B
2013,5786,Female,Sarawak,20,7,4,4,35,24,59,C
2018,5787,Female,Johor,19,4,7,4,34,31,65,B
2013,5788,Female,Malacca,13,3,3,5,24,26,50,C
2018,5789,Female,Malacca,15,4,6,5,30,38,68,B
2017,5790,Male,Pahang,17,6,6,1,30,40,70,B
2018,5791,Female,Selangor,16,4,10,1,31,30,61,B
2012,5792,Female,Sabah,18,4,9,4,35,31,66,B
2013,5793,Male,Selangor,20,4,5,5,34,39,73,B
2018,5794,Female,Kedah,18,10,4,3,35,22,57,C
2015,5795,Female,Terengganu,15,5,9,5,34,29,63,B
2012,5796,Male,Selangor,20,6,3,4,33,35,68,B
2012,5797,Male,Pahang,13,10,3,1,27,24,51,C
2017,5798,Female,Penang,16,5,5,3,29,36,65,B
2017,5799,Male,Penang,21,7,3,5,36,28,64,B
2019,5800,Female,Sabah,16,8,5,5,34,24,58,C
2015,5801,Female,Perlis,13,6,4,2,25,35,60,B
2016,5802,Male,Perak,21,3,10,1,35,35,70,B
2012,5803,Female,Selangor,20,9,4,3,36,29,65,B
2015,5804,Female,Terengganu,20,7,9,2,38,33,71,B
2018,5805,Male,Penang,16,6,9,2,33,37,70,B
2012,5806,Female,Penang,18,10,5,4,37,38,75,B
2018,5807,Female,Selangor,18,9,6,1,34,31,65,B
2015,5808,Male,Sarawak,14,6,10,3,33,26,59,C
2019,5809,Female,Perak,19,6,10,2,37,29,66,B
2018,5810,Female,Johor,15,7,3,2,27,28,55,C
2014,5811,Male,Perak,14,10,8,4,36,26,62,B
2019,5812,Male,Perlis,14,9,4,5,32,26,58,C
2016,5813,Female,Kelantan,16,10,5,3,34,35,69,B
2018,5814,Male,Penang,20,5,9,1,35,26,61,B
2014,5815,Female,Kelantan,20,9,4,3,36,22,58,C
2016,5816,Female,Johor,13,6,7,1,27,30,57,C
2014,5817,Female,Negeri Sembilan,18,5,5,3,31,34,65,B
2018,5818,Female,Kelantan,20,3,8,5,36,23,59,C
2016,5819,Male,Johor,20,4,9,5,38,22,60,B
2012,5820,Male,Negeri Sembilan,20,8,9,2,39,37,76,B
2016,5821,Female,Perak,15,4,5,1,25,27,52,C
2015,5822,Male,Sarawak,21,5,3,5,34,27,61,B
2013,5823,Female,Selangor,18,5,3,4,30,30,60,B
2016,5824,Female,Negeri Sembilan,13,9,10,2,34,31,65,B
2017,5825,Male,Malacca,19,9,7,5,40,35,75,B
2013,5826,Male,Penang,17,4,9,2,32,30,62,B
2015,5827,Female,Penang,14,6,10,2,32,23,55,C
2014,5828,Female,Kedah,13,5,4,2,24,39,63,B
2018,5829,Male,Pahang,16,9,3,1,29,38,67,B
2017,5830,Male,Kedah,13,4,9,2,28,23,51,C
2016,5831,Male,Pahang,15,10,7,2,34,24,58,C
2013,5832,Male,Penang,18,10,5,1,34,38,72,B
2014,5833,Female,Negeri Sembilan,14,6,7,5,32,35,67,B
2015,5834,Male,Pahang,16,6,7,5,34,34,68,B
2013,5835,Female,Sabah,13,8,3,1,25,33,58,C
2019,5836,Female,Malacca,20,8,9,2,39,24,63,B
2015,5837,Female,Sabah,21,8,8,4,41,24,65,B
2012,5838,Male,Sarawak,16,4,4,1,25,35,60,B
2014,5839,Female,Pahang,17,8,7,5,37,30,67,B
2018,5840,Female,Terengganu,17,7,10,5,39,25,64,B
2013,5841,Male,Sabah,18,10,3,1,32,26,58,C
2019,5842,Male,Malacca,13,8,5,2,28,28,56,C
2017,5843,Female,Penang,21,6,10,5,42,38,80,A
2018,5844,Male,Sarawak,21,5,5,1,32,35,67,B
2017,5845,Male,Kedah,21,4,5,2,32,39,71,B
2015,5846,Male,Penang,17,3,7,4,31,26,57,C
2019,5847,Male,Kedah,18,9,8,2,37,32,69,B
2014,5848,Female,Terengganu,19,7,5,5,36,34,70,B
2013,5849,Female,Malacca,16,9,10,3,38,37,75,B
2013,5850,Male,Perlis,17,10,5,1,33,38,71,B
2015,5851,Female,Sarawak,20,10,7,3,40,34,74,B
2017,5852,Male,Penang,20,7,10,3,40,39,79,A
2016,5853,Male,Selangor,18,3,7,3,31,35,66,B
2016,5854,Male,Sabah,15,4,7,3,29,22,51,C
2016,5855,Male,Sarawak,19,5,6,1,31,22,53,C
2017,5856,Male,Pahang,16,5,5,1,27,34,61,B
2016,5857,Male,Sarawak,16,6,9,1,32,27,59,C
2017,5858,Male,Sabah,19,9,8,1,37,32,69,B
2018,5859,Female,Kelantan,20,10,5,3,38,24,62,B
2016,5860,Female,Sabah,13,6,5,4,28,23,51,C
2016,5861,Female,Kedah,17,7,7,1,32,32,64,B
2016,5862,Male,Pahang,15,3,5,3,26,22,48,F
2012,5863,Female,Johor,18,10,9,5,42,24,66,B
2015,5864,Male,Sabah,17,6,10,2,35,28,63,B
2012,5865,Female,Kelantan,13,8,6,1,28,32,60,B
2015,5866,Female,Sarawak,15,7,3,1,26,28,54,C
2018,5867,Female,Malacca,15,8,7,2,32,28,60,B
2016,5868,Male,Selangor,20,7,3,5,35,38,73,B
2017,5869,Female,Penang,18,10,4,5,37,26,63,B
2016,5870,Male,Kelantan,20,6,10,3,39,30,69,B
2016,5871,Female,Johor,14,7,6,1,28,29,57,C
2016,5872,Male,Penang,18,3,7,5,33,32,65,B
2015,5873,Female,Selangor,21,9,7,2,39,38,77,B
2017,5874,Male,Pahang,20,8,5,4,37,38,75,B
2019,5875,Male,Pahang,14,5,6,4,29,34,63,B
2016,5876,Male,Kedah,17,9,10,3,39,37,76,B
2012,5877,Female,Selangor,17,5,3,5,30,35,65,B
2018,5878,Male,Terengganu,19,7,4,1,31,24,55,C
2014,5879,Female,Terengganu,14,7,10,4,35,34,69,B
2017,5880,Female,Sabah,15,4,7,1,27,26,53,C
2012,5881,Female,Perlis,18,10,7,5,40,35,75,B
2012,5882,Female,Negeri Sembilan,20,8,8,4,40,33,73,B
2019,5883,Male,Terengganu,19,5,4,4,32,33,65,B
2017,5884,Male,Negeri Sembilan,14,4,7,3,28,29,57,C
2019,5885,Male,Sabah,13,6,7,3,29,22,51,C
2012,5886,Male,Malacca,20,10,7,3,40,35,75,B
2012,5887,Male,Selangor,13,10,7,1,31,25,56,C
2018,5888,Male,Sarawak,21,10,3,3,37,31,68,B
2014,5889,Male,Penang,19,9,4,2,34,38,72,B
2015,5890,Male,Sarawak,17,4,8,4,33,29,62,B
2016,5891,Male,Negeri Sembilan,16,3,10,2,31,33,64,B
2017,5892,Female,Malacca,18,6,6,3,33,24,57,C
2015,5893,Male,Perak,20,4,8,4,36,33,69,B
2012,5894,Male,Kedah,14,7,5,3,29,22,51,C
2016,5895,Female,Negeri Sembilan,19,3,10,3,35,38,73,B
2016,5896,Female,Sabah,21,7,6,3,37,26,63,B
2017,5897,Male,Negeri Sembilan,17,6,4,5,32,33,65,B
2015,5898,Female,Terengganu,21,7,9,4,41,33,74,B
2014,5899,Female,Kelantan,21,5,5,3,34,28,62,B
2017,5900,Female,Sarawak,18,4,8,4,34,37,71,B
2015,5901,Male,Kelantan,20,4,5,3,32,40,72,B
2019,5902,Male,Sarawak,17,5,4,5,31,35,66,B
2018,5903,Female,Selangor,16,4,9,2,31,24,55,C
2019,5904,Female,Johor,19,10,5,5,39,38,77,B
2018,5905,Female,Perlis,14,5,6,5,30,31,61,B
2017,5906,Female,Perlis,21,4,5,5,35,28,63,B
2018,5907,Female,Terengganu,15,10,4,5,34,37,71,B
2019,5908,Female,Penang,14,6,3,1,24,31,55,C
2014,5909,Male,Perak,13,10,9,3,35,30,65,B
2013,5910,Male,Sabah,19,4,7,5,35,40,75,B
2016,5911,Female,Selangor,18,10,3,4,35,27,62,B
2016,5912,Male,Kelantan,21,8,4,2,35,35,70,B
2016,5913,Female,Perlis,20,8,5,2,35,29,64,B
2016,5914,Male,Selangor,16,6,7,3,32,32,64,B
2016,5915,Female,Sarawak,19,4,9,2,34,40,74,B
2019,5916,Male,Penang,13,4,4,5,26,35,61,B
2014,5917,Female,Perlis,21,9,4,2,36,29,65,B
2019,5918,Female,Selangor,18,9,7,3,37,34,71,B
2018,5919,Male,Negeri Sembilan,21,9,7,1,38,40,78,B
2019,5920,Male,Pahang,20,10,6,2,38,38,76,B
2019,5921,Female,Perak,14,5,3,1,23,28,51,C
2015,5922,Female,Sarawak,17,6,3,2,28,22,50,C
2012,5923,Female,Penang,21,7,7,1,36,37,73,B
2018,5924,Female,Penang,21,4,10,1,36,33,69,B
2016,5925,Female,Pahang,13,8,8,1,30,27,57,C
2017,5926,Male,Sabah,14,4,7,5,30,28,58,C
2018,5927,Female,Negeri Sembilan,19,6,8,5,38,38,76,B
2018,5928,Male,Perlis,17,3,9,1,30,37,67,B
2015,5929,Female,Terengganu,20,9,5,3,37,40,77,B
2014,5930,Male,Malacca,19,6,6,1,32,22,54,C
2016,5931,Male,Pahang,16,4,6,4,30,22,52,C
2018,5932,Male,Terengganu,13,3,7,5,28,38,66,B
2019,5933,Male,Perlis,18,6,5,1,30,29,59,C
2014,5934,Male,Johor,18,8,10,2,38,40,78,B
2013,5935,Female,Johor,20,7,6,2,35,24,59,C
2014,5936,Male,Selangor,14,3,7,3,27,29,56,C
2019,5937,Male,Pahang,13,10,5,4,32,30,62,B
2012,5938,Male,Malacca,17,8,3,2,30,33,63,B
2016,5939,Male,Kedah,17,10,6,3,36,26,62,B
2013,5940,Female,Sarawak,21,9,3,3,36,35,71,B
2018,5941,Female,Penang,13,3,3,5,24,28,52,C
2019,5942,Female,Kelantan,21,9,5,5,40,33,73,B
2016,5943,Female,Penang,13,3,4,2,22,24,46,F
2019,5944,Male,Sarawak,15,10,7,2,34,23,57,C
2019,5945,Male,Malacca,20,4,3,2,29,35,64,B
2019,5946,Male,Perak,20,5,3,3,31,29,60,B
2018,5947,Female,Kedah,16,6,7,3,32,34,66,B
2014,5948,Male,Kelantan,19,3,10,2,34,35,69,B
2012,5949,Male,Negeri Sembilan,20,5,6,2,33,27,60,B
2019,5950,Male,Perlis,21,9,6,5,41,38,79,A
2019,5951,Male,Sarawak,16,9,8,5,38,33,71,B
2016,5952,Female,Malacca,16,4,5,1,26,30,56,C
2016,5953,Female,Kedah,14,10,3,2,29,31,60,B
2018,5954,Female,Johor,19,10,8,2,39,27,66,B
2012,5955,Male,Malacca,17,9,10,3,39,28,67,B
2013,5956,Female,Terengganu,19,5,4,5,33,32,65,B
2014,5957,Female,Selangor,13,6,4,2,25,32,57,C
2014,5958,Female,Sarawak,18,4,3,4,29,34,63,B
2013,5959,Male,Kedah,14,4,8,3,29,31,60,B
2018,5960,Male,Selangor,16,4,5,2,27,30,57,C
2012,5961,Female,Kedah,17,10,9,2,38,23,61,B
2017,5962,Female,Perak,18,7,4,4,33,22,55,C
2013,5963,Female,Pahang,21,4,3,3,31,29,60,B
2017,5964,Female,Malacca,18,8,5,1,32,33,65,B
2015,5965,Female,Johor,17,5,7,5,34,35,69,B
2015,5966,Female,Perlis,16,4,4,1,25,36,61,B
2017,5967,Female,Terengganu,19,6,7,4,36,36,72,B
2016,5968,Male,Sabah,21,9,10,2,42,32,74,B
2012,5969,Female,Perlis,13,9,6,1,29,34,63,B
2019,5970,Male,Malacca,13,9,7,2,31,30,61,B
2013,5971,Female,Selangor,21,3,5,3,32,29,61,B
2012,5972,Male,Johor,18,8,9,2,37,34,71,B
2014,5973,Female,Kelantan,17,9,5,3,34,31,65,B
2014,5974,Male,Pahang,17,3,6,5,31,32,63,B
2015,5975,Female,Terengganu,15,8,7,1,31,40,71,B
2015,5976,Female,Sarawak,15,3,10,4,32,37,69,B
2014,5977,Female,Penang,15,7,5,1,28,40,68,B
2018,5978,Female,Sarawak,13,6,8,3,30,33,63,B
2017,5979,Male,Sarawak,13,9,3,1,26,35,61,B
2018,5980,Female,Sarawak,21,3,9,1,34,30,64,B
2015,5981,Male,Pahang,17,8,7,5,37,22,59,C
2014,5982,Male,Kelantan,13,6,7,5,31,40,71,B
2017,5983,Female,Sarawak,19,7,10,3,39,26,65,B
2014,5984,Female,Perak,14,8,8,4,34,25,59,C
2019,5985,Female,Johor,19,9,9,2,39,33,72,B
2016,5986,Male,Penang,15,4,6,5,30,34,64,B
2018,5987,Male,Kedah,16,10,6,2,34,25,59,C
2017,5988,Male,Malacca,19,4,9,1,33,40,73,B
2012,5989,Male,Terengganu,20,5,10,2,37,37,74,B
2015,5990,Male,Malacca,15,6,5,2,28,34,62,B
2019,5991,Male,Sabah,20,5,3,3,31,39,70,B
2018,5992,Male,Negeri Sembilan,21,5,7,4,37,39,76,B
2013,5993,Male,Malacca,13,10,8,4,35,31,66,B
2019,5994,Male,Terengganu,14,8,7,3,32,39,71,B
2019,5995,Male,Sabah,13,5,9,2,29,32,61,B
2019,5996,Male,Kelantan,16,7,6,4,33,27,60,B
2018,5997,Male,Terengganu,19,7,8,2,36,34,70,B
2014,5998,Male,Pahang,15,9,6,1,31,36,67,B
2012,5999,Female,Johor,15,4,5,1,25,38,63,B
2017,6000,Male,Pahang,18,6,4,3,31,35,66,B
2018,6001,Male,Johor,20,4,4,4,32,40,72,B
2015,6002,Male,Sabah,21,9,6,2,38,37,75,B
2015,6003,Male,Sarawak,15,7,5,3,30,31,61,B
2017,6004,Male,Pahang,17,10,7,1,35,28,63,B
2013,6005,Female,Penang,18,5,5,1,29,39,68,B
2016,6006,Female,Sarawak,15,6,9,1,31,24,55,C
2012,6007,Female,Pahang,13,7,8,5,33,25,58,C
2015,6008,Male,Negeri Sembilan,20,3,4,4,31,25,56,C
2014,6009,Female,Terengganu,15,9,8,4,36,23,59,C
2019,6010,Female,Kelantan,19,7,4,5,35,22,57,C
2015,6011,Male,Perlis,17,7,8,2,34,31,65,B
2012,6012,Male,Perlis,15,4,3,3,25,25,50,C
2018,6013,Male,Negeri Sembilan,13,5,6,2,26,24,50,C
2013,6014,Female,Penang,16,3,8,2,29,25,54,C
2014,6015,Male,Pahang,16,3,7,3,29,37,66,B
2012,6016,Female,Johor,17,5,8,3,33,34,67,B
2019,6017,Female,Perak,13,7,8,2,30,27,57,C
2012,6018,Female,Penang,18,8,6,5,37,39,76,B
2018,6019,Male,Pahang,18,7,10,5,40,40,80,A
2017,6020,Male,Selangor,20,8,5,4,37,39,76,B
2014,6021,Female,Negeri Sembilan,17,6,9,4,36,24,60,B
2013,6022,Male,Penang,18,10,10,3,41,25,66,B
2019,6023,Female,Selangor,17,6,4,3,30,37,67,B
2018,6024,Female,Negeri Sembilan,13,6,4,2,25,30,55,C
2018,6025,Male,Pahang,20,9,5,5,39,25,64,B
2014,6026,Female,Sarawak,13,9,10,3,35,27,62,B
2019,6027,Female,Penang,16,9,10,4,39,29,68,B
2014,6028,Male,Penang,20,5,6,2,33,27,60,B
2013,6029,Male,Negeri Sembilan,14,7,8,3,32,26,58,C
2017,6030,Female,Johor,19,3,5,4,31,34,65,B
2014,6031,Male,Terengganu,19,4,8,5,36,22,58,C
2013,6032,Female,Penang,17,9,5,3,34,31,65,B
2016,6033,Male,Malacca,15,9,7,4,35,31,66,B
2014,6034,Male,Johor,21,9,3,2,35,37,72,B
2016,6035,Male,Kedah,13,5,3,1,22,38,60,B
2015,6036,Male,Kedah,17,10,9,1,37,38,75,B
2017,6037,Female,Negeri Sembilan,16,5,4,2,27,40,67,B
2015,6038,Male,Selangor,20,9,4,3,36,24,60,B
2015,6039,Female,Johor,19,3,6,5,33,36,69,B
2013,6040,Male,Kelantan,15,9,5,3,32,34,66,B
2016,6041,Female,Sarawak,20,5,5,3,33,27,60,B
2015,6042,Female,Sarawak,17,5,4,1,27,29,56,C
2014,6043,Female,Negeri Sembilan,15,8,7,1,31,37,68,B
2015,6044,Female,Johor,21,9,3,3,36,29,65,B
2016,6045,Female,Penang,17,6,5,2,30,40,70,B
2018,6046,Female,Johor,16,5,9,4,34,30,64,B
2013,6047,Female,Malacca,13,8,4,5,30,36,66,B
2016,6048,Male,Selangor,19,8,9,3,39,38,77,B
2015,6049,Male,Sarawak,17,4,6,1,28,26,54,C
2017,6050,Female,Selangor,20,6,6,4,36,25,61,B
2015,6051,Male,Terengganu,15,3,10,4,32,23,55,C
2016,6052,Female,Sabah,17,8,7,3,35,25,60,B
2012,6053,Female,Sabah,20,8,10,3,41,39,80,A
2018,6054,Male,Perak,17,9,10,1,37,33,70,B
2017,6055,Female,Selangor,17,10,8,1,36,33,69,B
2015,6056,Male,Perlis,13,7,9,4,33,35,68,B
2014,6057,Male,Negeri Sembilan,13,4,3,5,25,33,58,C
2019,6058,Male,Kedah,21,10,8,4,43,39,82,A
2019,6059,Female,Negeri Sembilan,19,9,8,3,39,33,72,B
2013,6060,Male,Perlis,20,7,3,5,35,36,71,B
2018,6061,Female,Terengganu,20,6,4,3,33,34,67,B
2014,6062,Female,Kelantan,20,4,9,4,37,39,76,B
2016,6063,Male,Kelantan,15,7,9,2,33,39,72,B
2017,6064,Male,Terengganu,18,4,5,1,28,29,57,C
2014,6065,Female,Selangor,15,9,7,5,36,33,69,B
2017,6066,Female,Sarawak,14,9,3,1,27,22,49,F
2013,6067,Female,Terengganu,17,3,6,2,28,27,55,C
2012,6068,Female,Kelantan,19,7,9,5,40,37,77,B
2017,6069,Male,Terengganu,20,5,7,5,37,28,65,B
2014,6070,Female,Perlis,20,3,8,5,36,30,66,B
2015,6071,Female,Sabah,20,10,3,1,34,23,57,C
2015,6072,Male,Terengganu,19,6,6,3,34,27,61,B
2017,6073,Male,Kedah,13,7,6,3,29,24,53,C
2016,6074,Female,Sabah,20,7,4,3,34,24,58,C
2015,6075,Male,Negeri Sembilan,17,9,6,5,37,38,75,B
2015,6076,Female,Terengganu,13,8,8,3,32,26,58,C
2014,6077,Male,Kelantan,18,5,5,4,32,38,70,B
2019,6078,Female,Selangor,17,3,3,5,28,26,54,C
2019,6079,Male,Johor,18,9,7,2,36,34,70,B
2014,6080,Female,Kedah,21,5,4,3,33,28,61,B
2014,6081,Male,Malacca,18,4,3,1,26,36,62,B
2019,6082,Female,Perlis,21,8,10,5,44,22,66,B
2013,6083,Female,Negeri Sembilan,19,9,7,4,39,34,73,B
2014,6084,Male,Sarawak,20,6,4,2,32,32,64,B
2016,6085,Female,Kelantan,19,8,6,1,34,34,68,B
2017,6086,Male,Kedah,15,6,7,3,31,28,59,C
2014,6087,Female,Sarawak,19,5,10,3,37,32,69,B
2013,6088,Male,Johor,17,4,7,5,33,22,55,C
2013,6089,Male,Negeri Sembilan,20,9,8,4,41,29,70,B
2013,6090,Male,Sarawak,14,7,5,1,27,36,63,B
2012,6091,Female,Perak,14,7,6,3,30,34,64,B
2018,6092,Male,Johor,13,5,3,1,22,30,52,C
2014,6093,Male,Pahang,17,10,7,1,35,29,64,B
2018,6094,Female,Terengganu,17,10,7,3,37,22,59,C
2013,6095,Female,Sarawak,15,9,6,5,35,39,74,B
2012,6096,Male,Pahang,21,3,8,2,34,40,74,B
2015,6097,Female,Pahang,17,10,9,2,38,24,62,B
2015,6098,Male,Malacca,21,3,3,5,32,31,63,B
2018,6099,Female,Perak,21,5,6,4,36,35,71,B
2018,6100,Female,Terengganu,18,4,7,2,31,32,63,B
2014,6101,Male,Selangor,16,3,9,3,31,27,58,C
2012,6102,Female,Perak,19,5,4,1,29,33,62,B
2015,6103,Female,Johor,17,9,4,3,33,34,67,B
2015,6104,Male,Negeri Sembilan,13,7,3,1,24,24,48,F
2017,6105,Female,Pahang,14,5,10,3,32,37,69,B
2019,6106,Male,Malacca,18,5,9,5,37,38,75,B
2019,6107,Male,Malacca,14,4,8,3,29,25,54,C
2015,6108,Female,Negeri Sembilan,19,6,6,2,33,25,58,C
2017,6109,Male,Johor,14,3,3,2,22,25,47,F
2012,6110,Female,Negeri Sembilan,15,9,8,4,36,24,60,B
2018,6111,Male,Terengganu,13,5,3,4,25,37,62,B
2013,6112,Female,Sabah,16,9,6,1,32,31,63,B
2013,6113,Female,Kedah,17,6,3,5,31,35,66,B
2014,6114,Male,Perak,17,5,10,5,37,29,66,B
2015,6115,Female,Negeri Sembilan,14,3,3,1,21,35,56,C
2017,6116,Female,Terengganu,18,4,10,2,34,30,64,B
2014,6117,Male,Kelantan,13,7,3,5,28,25,53,C
2014,6118,Female,Pahang,14,9,3,4,30,27,57,C
2018,6119,Male,Selangor,20,8,8,1,37,34,71,B
2017,6120,Male,Pahang,16,5,3,2,26,39,65,B
2013,6121,Female,Negeri Sembilan,20,5,8,5,38,31,69,B
2012,6122,Male,Kedah,21,3,9,2,35,33,68,B
2016,6123,Male,Terengganu,14,10,8,2,34,30,64,B
2012,6124,Female,Penang,17,5,5,3,30,30,60,B
2012,6125,Male,Sabah,14,6,10,5,35,30,65,B
2013,6126,Female,Negeri Sembilan,17,3,8,3,31,35,66,B
2019,6127,Female,Pahang,16,10,3,3,32,25,57,C
2018,6128,Male,Kedah,17,4,8,4,33,30,63,B
2016,6129,Female,Johor,13,9,5,5,32,34,66,B
2017,6130,Female,Terengganu,17,7,10,4,38,24,62,B
2013,6131,Female,Johor,18,10,6,5,39,27,66,B
2014,6132,Male,Penang,16,3,4,4,27,38,65,B
2016,6133,Male,Negeri Sembilan,19,4,4,5,32,27,59,C
2016,6134,Male,Malacca,19,7,7,2,35,25,60,B
2016,6135,Female,Perak,15,10,10,2,37,38,75,B
2012,6136,Female,Kedah,14,6,4,3,27,33,60,B
2012,6137,Female,Selangor,14,8,7,2,31,33,64,B
2012,6138,Female,Perak,21,8,8,4,41,37,78,B
2017,6139,Male,Selangor,13,10,3,3,29,27,56,C
2013,6140,Female,Perak,13,8,3,2,26,35,61,B
2018,6141,Female,Selangor,19,5,8,1,33,39,72,B
2016,6142,Female,Sabah,13,3,10,1,27,23,50,C
2017,6143,Male,Kedah,15,8,3,4,30,36,66,B
2014,6144,Male,Negeri Sembilan,13,6,3,2,24,38,62,B
2012,6145,Male,Pahang,18,4,6,1,29,22,51,C
2014,6146,Male,Kedah,16,4,9,1,30,30,60,B
2018,6147,Female,Perak,20,10,7,1,38,32,70,B
2016,6148,Male,Sabah,18,9,6,4,37,26,63,B
2012,6149,Male,Johor,18,5,6,1,30,26,56,C
2019,6150,Male,Malacca,14,4,6,2,26,35,61,B
2014,6151,Female,Johor,17,6,6,3,32,27,59,C
2016,6152,Male,Kedah,20,10,9,3,42,22,64,B
2014,6153,Female,Perak,19,5,7,1,32,24,56,C
2016,6154,Female,Kelantan,19,6,5,4,34,27,61,B
2017,6155,Male,Negeri Sembilan,13,8,4,3,28,38,66,B
2014,6156,Female,Perak,14,5,5,3,27,31,58,C
2018,6157,Female,Sarawak,21,7,5,1,34,40,74,B
2019,6158,Female,Perak,20,3,8,1,32,28,60,B
2013,6159,Female,Pahang,18,9,4,3,34,23,57,C
2014,6160,Male,Penang,15,7,5,1,28,39,67,B
2015,6161,Female,Pahang,18,6,4,1,29,35,64,B
2013,6162,Male,Negeri Sembilan,19,3,3,5,30,35,65,B
2012,6163,Female,Negeri Sembilan,21,10,9,4,44,38,82,A
2014,6164,Female,Sabah,14,9,8,4,35,33,68,B
2014,6165,Male,Kedah,17,4,7,4,32,35,67,B
2017,6166,Female,Kelantan,17,5,9,3,34,26,60,B
2014,6167,Female,Penang,20,7,6,3,36,28,64,B
2017,6168,Male,Terengganu,20,3,9,1,33,29,62,B
2017,6169,Female,Pahang,19,3,6,1,29,35,64,B
2015,6170,Female,Sarawak,13,3,5,2,23,29,52,C
2019,6171,Female,Johor,13,8,7,2,30,30,60,B
2019,6172,Male,Malacca,14,4,4,2,24,36,60,B
2015,6173,Female,Pahang,20,7,7,4,38,31,69,B
2016,6174,Male,Malacca,18,7,7,4,36,31,67,B
2016,6175,Female,Penang,13,10,8,1,32,32,64,B
2019,6176,Male,Johor,18,9,9,1,37,31,68,B
2017,6177,Female,Kedah,14,9,5,3,31,39,70,B
2019,6178,Female,Penang,14,9,4,1,28,40,68,B
2012,6179,Male,Selangor,16,9,5,3,33,40,73,B
2015,6180,Male,Penang,20,7,3,1,31,22,53,C
2017,6181,Male,Kedah,19,3,4,2,28,29,57,C
2013,6182,Female,Negeri Sembilan,17,10,9,3,39,30,69,B
2012,6183,Female,Kelantan,15,8,6,3,32,23,55,C
2013,6184,Female,Perlis,14,7,10,3,34,25,59,C
2014,6185,Male,Sarawak,21,5,7,3,36,26,62,B
2018,6186,Female,Terengganu,16,7,5,5,33,38,71,B
2017,6187,Male,Pahang,17,5,10,4,36,28,64,B
2018,6188,Female,Penang,17,5,3,5,30,26,56,C
2015,6189,Male,Kedah,16,4,10,1,31,26,57,C
2018,6190,Male,Sarawak,20,7,8,3,38,36,74,B
2017,6191,Male,Sarawak,20,7,10,3,40,37,77,B
2014,6192,Male,Negeri Sembilan,20,10,8,4,42,38,80,A
2015,6193,Female,Selangor,21,10,9,2,42,29,71,B
2014,6194,Female,Kelantan,14,5,6,4,29,33,62,B
2013,6195,Female,Kedah,20,3,10,2,35,24,59,C
2013,6196,Female,Negeri Sembilan,15,8,5,1,29,22,51,C
2012,6197,Female,Perlis,20,4,5,2,31,25,56,C
2015,6198,Female,Perak,16,3,6,5,30,34,64,B
2015,6199,Female,Sarawak,18,4,3,3,28,26,54,C
2013,6200,Male,Perlis,15,10,5,3,33,32,65,B
2015,6201,Female,Sabah,21,5,9,5,40,35,75,B
2012,6202,Male,Perlis,14,6,5,4,29,33,62,B
2019,6203,Female,Perak,18,9,10,3,40,33,73,B
2018,6204,Male,Kedah,15,8,10,2,35,37,72,B
2017,6205,Male,Kelantan,19,10,7,4,40,29,69,B
2016,6206,Male,Selangor,19,5,8,3,35,26,61,B
2015,6207,Female,Sabah,14,5,3,4,26,38,64,B
2013,6208,Male,Perlis,20,3,4,5,32,31,63,B
2012,6209,Male,Sabah,17,7,9,1,34,23,57,C
2016,6210,Female,Perlis,17,7,10,3,37,32,69,B
2015,6211,Female,Malacca,21,5,8,3,37,25,62,B
2017,6212,Male,Selangor,14,3,3,5,25,22,47,F
2013,6213,Male,Kedah,18,7,5,5,35,39,74,B
2014,6214,Male,Perak,21,6,6,4,37,31,68,B
2017,6215,Male,Perak,18,7,3,4,32,37,69,B
2016,6216,Male,Sabah,17,6,7,4,34,30,64,B
2014,6217,Male,Malacca,19,6,4,3,32,38,70,B
2019,6218,Female,Sabah,21,7,9,2,39,27,66,B
2016,6219,Female,Perlis,17,8,3,5,33,29,62,B
2017,6220,Female,Kelantan,15,8,5,1,29,40,69,B
2017,6221,Male,Kedah,14,5,5,1,25,33,58,C
2012,6222,Female,Sarawak,18,9,5,3,35,38,73,B
2017,6223,Female,Malacca,19,4,8,1,32,28,60,B
2013,6224,Female,Negeri Sembilan,18,8,3,2,31,40,71,B
2012,6225,Female,Terengganu,18,8,10,4,40,39,79,A
2016,6226,Female,Kelantan,16,10,8,5,39,40,79,A
2012,6227,Male,Negeri Sembilan,13,3,4,2,22,27,49,F
2016,6228,Male,Terengganu,20,10,8,5,43,35,78,B
2016,6229,Female,Terengganu,15,6,3,5,29,28,57,C
2015,6230,Female,Sarawak,16,5,8,4,33,26,59,C
2013,6231,Female,Kelantan,16,8,9,2,35,39,74,B
2012,6232,Female,Perak,18,10,9,2,39,33,72,B
2017,6233,Female,Selangor,19,4,8,2,33,39,72,B
2013,6234,Female,Sabah,13,5,5,2,25,29,54,C
2019,6235,Female,Kelantan,15,8,6,5,34,26,60,B
2012,6236,Male,Perlis,18,4,3,5,30,37,67,B
2016,6237,Female,Sarawak,16,7,5,5,33,38,71,B
2016,6238,Male,Terengganu,20,4,9,1,34,23,57,C
2019,6239,Male,Pahang,21,6,4,2,33,38,71,B
2017,6240,Female,Pahang,13,10,3,1,27,24,51,C
2019,6241,Male,Sabah,13,6,8,3,30,30,60,B
2014,6242,Female,Perlis,19,10,7,4,40,38,78,B
2018,6243,Male,Johor,17,5,8,5,35,32,67,B
2014,6244,Male,Kelantan,16,8,3,5,32,34,66,B
2017,6245,Male,Kelantan,15,7,3,4,29,29,58,C
2019,6246,Female,Negeri Sembilan,14,4,5,2,25,31,56,C
2017,6247,Male,Penang,17,6,5,4,32,33,65,B
2019,6248,Male,Perak,19,5,4,5,33,33,66,B
2014,6249,Male,Terengganu,16,3,7,4,30,40,70,B
2012,6250,Female,Perak,21,7,4,1,33,29,62,B
2015,6251,Female,Selangor,13,5,5,4,27,33,60,B
2014,6252,Male,Kedah,15,6,7,4,32,29,61,B
2019,6253,Male,Penang,19,4,4,2,29,24,53,C
2019,6254,Female,Terengganu,21,7,9,2,39,25,64,B
2013,6255,Male,Terengganu,19,5,10,4,38,24,62,B
2015,6256,Female,Negeri Sembilan,18,4,10,3,35,39,74,B
2018,6257,Female,Selangor,19,6,6,5,36,30,66,B
2012,6258,Female,Negeri Sembilan,19,3,7,5,34,34,68,B
2016,6259,Female,Kelantan,18,6,5,5,34,26,60,B
2014,6260,Female,Johor,13,10,9,5,37,39,76,B
2017,6261,Male,Negeri Sembilan,21,9,3,4,37,22,59,C
2016,6262,Female,Sarawak,15,9,7,4,35,38,73,B
2018,6263,Male,Malacca,17,4,4,1,26,35,61,B
2018,6264,Female,Perlis,21,3,8,1,33,38,71,B
2016,6265,Male,Perak,16,9,7,5,37,25,62,B
2014,6266,Male,Pahang,15,3,5,4,27,28,55,C
2018,6267,Female,Sabah,18,7,8,1,34,28,62,B
2017,6268,Female,Pahang,13,8,5,1,27,24,51,C
2012,6269,Female,Kelantan,17,6,5,4,32,25,57,C
2012,6270,Male,Kedah,18,8,10,3,39,37,76,B
2014,6271,Male,Kelantan,21,5,10,4,40,33,73,B
2017,6272,Female,Perlis,14,6,3,5,28,37,65,B
2014,6273,Female,Penang,20,6,6,1,33,26,59,C
2015,6274,Female,Negeri Sembilan,19,4,7,1,31,26,57,C
2017,6275,Female,Perlis,13,6,9,3,31,29,60,B
2012,6276,Female,Selangor,13,10,5,3,31,37,68,B
2018,6277,Female,Perlis,15,3,9,1,28,39,67,B
2019,6278,Male,Perlis,19,10,3,4,36,40,76,B
2019,6279,Female,Perlis,17,4,6,3,30,26,56,C
2016,6280,Female,Pahang,20,6,7,3,36,40,76,B
2012,6281,Male,Perak,17,4,4,1,26,36,62,B
2017,6282,Female,Pahang,14,7,4,3,28,28,56,C
2014,6283,Male,Malacca,21,10,10,4,45,30,75,B
2014,6284,Female,Kelantan,17,6,8,5,36,33,69,B
2015,6285,Female,Sarawak,20,3,3,5,31,24,55,C
2014,6286,Female,Pahang,17,8,4,1,30,35,65,B
2014,6287,Female,Perak,20,3,6,1,30,30,60,B
2017,6288,Male,Negeri Sembilan,18,6,3,1,28,35,63,B
2015,6289,Male,Terengganu,16,7,5,5,33,32,65,B
2015,6290,Female,Terengganu,21,5,4,3,33,25,58,C
2012,6291,Female,Selangor,19,4,3,1,27,32,59,C
2016,6292,Male,Kelantan,14,3,10,3,30,29,59,C
2014,6293,Female,Terengganu,17,4,9,3,33,36,69,B
2018,6294,Male,Sabah,19,7,9,4,39,27,66,B
2012,6295,Male,Kelantan,18,7,10,1,36,25,61,B
2014,6296,Male,Malacca,19,4,7,3,33,31,64,B
2014,6297,Male,Negeri Sembilan,17,5,4,4,30,31,61,B
2016,6298,Female,Terengganu,15,8,6,1,30,24,54,C
2017,6299,Male,Sarawak,19,4,10,2,35,38,73,B
2016,6300,Female,Perlis,17,8,9,4,38,27,65,B
2019,6301,Male,Perak,21,3,5,3,32,25,57,C
2012,6302,Female,Penang,14,5,6,2,27,40,67,B
2012,6303,Female,Perlis,18,5,5,2,30,26,56,C
2018,6304,Male,Perlis,18,6,10,3,37,40,77,B
2019,6305,Female,Johor,16,8,5,1,30,38,68,B
2014,6306,Female,Kedah,19,8,10,5,42,34,76,B
2013,6307,Female,Negeri Sembilan,20,6,3,2,31,31,62,B
2017,6308,Female,Pahang,19,3,8,1,31,39,70,B
2012,6309,Female,Perak,18,10,10,4,42,40,82,A
2012,6310,Male,Kelantan,18,6,9,4,37,22,59,C
2017,6311,Male,Perlis,15,3,5,5,28,37,65,B
2014,6312,Male,Pahang,15,3,10,2,30,28,58,C
2013,6313,Male,Malacca,20,8,4,2,34,36,70,B
2019,6314,Male,Perlis,13,7,8,5,33,32,65,B
2013,6315,Female,Kelantan,13,6,5,3,27,36,63,B
2012,6316,Female,Johor,14,8,6,3,31,22,53,C
2013,6317,Male,Malacca,16,10,9,5,40,31,71,B
2019,6318,Male,Perak,21,5,3,3,32,33,65,B
2013,6319,Female,Kelantan,18,10,7,2,37,40,77,B
2012,6320,Female,Sarawak,14,5,10,3,32,22,54,C
2015,6321,Male,Johor,17,8,3,1,29,36,65,B
2016,6322,Female,Pahang,19,8,5,4,36,28,64,B
2014,6323,Female,Perak,20,10,8,3,41,34,75,B
2012,6324,Female,Kelantan,18,8,10,3,39,23,62,B
2017,6325,Male,Malacca,17,10,8,4,39,24,63,B
2015,6326,Male,Kedah,17,5,3,3,28,22,50,C
2017,6327,Female,Negeri Sembilan,19,7,7,2,35,29,64,B
2018,6328,Male,Johor,15,6,10,3,34,37,71,B
2018,6329,Male,Sabah,20,8,10,1,39,39,78,B
2018,6330,Male,Kedah,15,8,5,3,31,35,66,B
2015,6331,Female,Perlis,19,4,4,3,30,31,61,B
2017,6332,Female,Perak,15,10,7,3,35,34,69,B
2012,6333,Male,Malacca,19,5,7,4,35,34,69,B
2016,6334,Female,Sabah,17,6,6,4,33,30,63,B
2016,6335,Female,Pahang,15,7,10,1,33,27,60,B
2012,6336,Male,Perlis,13,9,3,4,29,22,51,C
2014,6337,Female,Negeri Sembilan,16,3,5,5,29,22,51,C
2017,6338,Female,Kedah,15,8,6,5,34,22,56,C
2015,6339,Male,Pahang,19,7,3,1,30,26,56,C
2017,6340,Female,Perak,16,8,10,5,39,34,73,B
2015,6341,Female,Kelantan,18,5,4,4,31,30,61,B
2012,6342,Female,Kedah,16,8,6,3,33,26,59,C
2017,6343,Male,Sabah,16,5,10,4,35,32,67,B
2017,6344,Male,Sarawak,16,9,8,5,38,32,70,B
2018,6345,Female,Kelantan,20,3,9,2,34,36,70,B
2012,6346,Male,Kedah,20,5,8,3,36,37,73,B
2017,6347,Male,Johor,13,8,3,5,29,40,69,B
2019,6348,Male,Sarawak,13,4,5,2,24,39,63,B
2012,6349,Female,Kelantan,21,3,7,1,32,28,60,B
2012,6350,Male,Negeri Sembilan,16,6,7,3,32,22,54,C
2012,6351,Male,Malacca,16,4,5,3,28,23,51,C
2016,6352,Male,Johor,18,7,7,4,36,29,65,B
2014,6353,Female,Negeri Sembilan,17,4,7,3,31,39,70,B
2012,6354,Male,Sabah,14,5,10,3,32,28,60,B
2019,6355,Female,Terengganu,13,3,5,1,22,34,56,C
2015,6356,Male,Kelantan,17,6,7,2,32,24,56,C
2015,6357,Female,Perak,19,7,5,1,32,22,54,C
2014,6358,Female,Kelantan,19,3,8,5,35,22,57,C
2019,6359,Female,Kedah,18,3,8,5,34,39,73,B
2019,6360,Female,Pahang,15,7,7,2,31,36,67,B
2018,6361,Male,Kedah,19,5,9,3,36,38,74,B
2018,6362,Female,Malacca,21,6,7,2,36,32,68,B
2015,6363,Male,Negeri Sembilan,17,10,8,5,40,38,78,B
2015,6364,Male,Terengganu,16,10,10,5,41,25,66,B
2013,6365,Male,Malacca,21,10,4,5,40,24,64,B
2016,6366,Male,Johor,16,3,6,2,27,22,49,F
2017,6367,Female,Negeri Sembilan,21,3,8,3,35,22,57,C
2017,6368,Female,Sabah,16,5,4,2,27,29,56,C
2014,6369,Male,Selangor,21,7,3,4,35,39,74,B
2013,6370,Male,Sabah,13,3,9,5,30,36,66,B
2019,6371,Male,Kedah,16,8,3,2,29,37,66,B
2014,6372,Female,Perak,13,5,8,5,31,35,66,B
2013,6373,Female,Selangor,16,10,8,1,35,24,59,C
2014,6374,Male,Kelantan,13,6,7,2,28,39,67,B
2017,6375,Female,Sarawak,19,3,3,2,27,24,51,C
2019,6376,Female,Kelantan,19,10,3,2,34,37,71,B
2013,6377,Female,Pahang,18,8,10,5,41,25,66,B
2014,6378,Male,Perak,18,4,5,4,31,34,65,B
2014,6379,Female,Kedah,16,6,4,2,28,22,50,C
2014,6380,Female,Kelantan,18,9,6,2,35,34,69,B
2018,6381,Male,Johor,18,7,7,5,37,28,65,B
2014,6382,Female,Malacca,21,8,6,2,37,32,69,B
2015,6383,Female,Pahang,17,10,3,1,31,26,57,C
2014,6384,Male,Johor,18,6,9,2,35,24,59,C
2013,6385,Female,Sarawak,17,3,8,3,31,36,67,B
2018,6386,Female,Perlis,19,5,5,1,30,26,56,C
2016,6387,Female,Kedah,15,4,9,1,29,32,61,B
2014,6388,Male,Perlis,18,3,10,1,32,35,67,B
2012,6389,Female,Selangor,18,6,9,3,36,36,72,B
2013,6390,Male,Selangor,14,3,4,4,25,31,56,C
2019,6391,Male,Pahang,13,10,5,1,29,36,65,B
2014,6392,Female,Selangor,19,10,8,5,42,26,68,B
2016,6393,Female,Terengganu,21,7,9,1,38,24,62,B
2013,6394,Male,Negeri Sembilan,18,3,3,4,28,39,67,B
2012,6395,Male,Pahang,15,7,8,5,35,22,57,C
2013,6396,Male,Terengganu,13,10,5,5,33,40,73,B
2014,6397,Male,Perak,14,5,7,2,28,39,67,B
2013,6398,Male,Selangor,15,6,7,4,32,24,56,C
2017,6399,Female,Terengganu,14,3,5,5,27,32,59,C
2015,6400,Male,Johor,13,9,6,3,31,34,65,B
2018,6401,Female,Negeri Sembilan,21,7,3,4,35,39,74,B
2013,6402,Male,Perlis,14,6,5,1,26,40,66,B
2018,6403,Female,Pahang,20,5,10,1,36,40,76,B
2016,6404,Male,Kelantan,17,5,3,3,28,25,53,C
2017,6405,Male,Sabah,17,6,3,1,27,36,63,B
2015,6406,Male,Perlis,16,3,4,4,27,35,62,B
2016,6407,Female,Sarawak,14,6,4,1,25,28,53,C
2014,6408,Female,Johor,20,8,5,2,35,28,63,B
2014,6409,Female,Malacca,15,7,8,4,34,27,61,B
2012,6410,Male,Perak,21,8,3,2,34,32,66,B
2019,6411,Male,Perak,16,10,8,5,39,22,61,B
2013,6412,Female,Negeri Sembilan,13,4,5,1,23,35,58,C
2018,6413,Male,Perlis,13,10,6,5,34,33,67,B
2013,6414,Male,Sarawak,15,4,10,5,34,39,73,B
2016,6415,Female,Pahang,13,10,4,5,32,24,56,C
2013,6416,Female,Pahang,16,6,8,1,31,38,69,B
2012,6417,Female,Perak,17,5,8,1,31,30,61,B
2016,6418,Female,Perak,19,5,10,4,38,30,68,B
2014,6419,Female,Sabah,17,10,8,1,36,23,59,C
2017,6420,Female,Perlis,21,9,4,5,39,35,74,B
2012,6421,Male,Negeri Sembilan,13,9,3,1,26,23,49,F
2015,6422,Female,Penang,20,7,10,1,38,24,62,B
2017,6423,Male,Perlis,19,8,6,5,38,29,67,B
2015,6424,Female,Johor,19,10,8,1,38,26,64,B
2014,6425,Male,Selangor,16,7,3,5,31,34,65,B
2018,6426,Male,Perak,17,9,10,3,39,27,66,B
2019,6427,Male,Selangor,20,4,4,5,33,36,69,B
2013,6428,Male,Malacca,13,5,10,5,33,23,56,C
2016,6429,Female,Pahang,14,5,4,3,26,34,60,B
2019,6430,Female,Negeri Sembilan,14,7,6,2,29,34,63,B
2018,6431,Male,Terengganu,19,10,9,1,39,22,61,B
2012,6432,Female,Sabah,14,8,6,1,29,33,62,B
2013,6433,Female,Penang,19,8,3,2,32,32,64,B
2013,6434,Female,Perlis,13,8,8,4,33,34,67,B
2014,6435,Male,Sabah,16,7,9,5,37,30,67,B
2014,6436,Male,Terengganu,17,4,3,4,28,31,59,C
2019,6437,Female,Penang,15,9,5,4,33,24,57,C
2015,6438,Female,Terengganu,16,8,3,1,28,36,64,B
2016,6439,Male,Johor,19,7,10,5,41,30,71,B
2012,6440,Female,Selangor,21,10,10,3,44,36,80,A
2019,6441,Male,Johor,19,10,3,1,33,23,56,C
2014,6442,Female,Sabah,16,3,9,5,33,27,60,B
2019,6443,Male,Johor,17,7,8,3,35,27,62,B
2014,6444,Female,Perak,18,3,9,1,31,35,66,B
2012,6445,Male,Penang,15,5,7,4,31,33,64,B
2016,6446,Female,Negeri Sembilan,18,3,7,1,29,22,51,C
2012,6447,Female,Kelantan,16,8,10,5,39,33,72,B
2012,6448,Female,Johor,13,3,8,2,26,25,51,C
2019,6449,Male,Perak,21,3,3,3,30,31,61,B
2018,6450,Female,Sabah,18,9,5,5,37,35,72,B
2017,6451,Male,Malacca,20,4,9,2,35,30,65,B
2013,6452,Female,Perlis,13,9,4,3,29,25,54,C
2015,6453,Female,Negeri Sembilan,14,3,9,3,29,36,65,B
2016,6454,Female,Kedah,21,8,3,2,34,40,74,B
2016,6455,Female,Pahang,18,9,4,4,35,27,62,B
2018,6456,Female,Selangor,19,9,5,1,34,25,59,C
2018,6457,Male,Sabah,16,4,8,1,29,36,65,B
2016,6458,Female,Johor,18,8,4,3,33,36,69,B
2016,6459,Male,Pahang,17,9,9,2,37,28,65,B
2013,6460,Female,Perak,20,7,10,3,40,26,66,B
2016,6461,Male,Perlis,18,9,6,5,38,39,77,B
2017,6462,Female,Pahang,16,10,4,4,34,38,72,B
2017,6463,Female,Kedah,17,5,6,3,31,22,53,C
2018,6464,Male,Selangor,14,10,9,5,38,22,60,B
2015,6465,Female,Kelantan,15,8,10,1,34,32,66,B
2017,6466,Male,Kedah,16,3,6,4,29,35,64,B
2019,6467,Male,Selangor,18,8,9,3,38,25,63,B
2012,6468,Male,Perak,15,3,4,5,27,30,57,C
2016,6469,Male,Perak,19,5,3,2,29,28,57,C
2013,6470,Male,Johor,21,4,3,5,33,23,56,C
2012,6471,Male,Malacca,18,3,7,2,30,34,64,B
2014,6472,Male,Pahang,16,10,5,1,32,34,66,B
2016,6473,Male,Perak,20,8,6,3,37,38,75,B
2013,6474,Male,Pahang,17,6,8,2,33,30,63,B
2015,6475,Male,Kelantan,17,6,7,1,31,30,61,B
2015,6476,Male,Pahang,19,4,9,2,34,30,64,B
2013,6477,Male,Johor,20,8,6,3,37,33,70,B
2019,6478,Male,Johor,13,10,9,1,33,26,59,C
2016,6479,Male,Kelantan,19,5,9,3,36,35,71,B
2014,6480,Female,Pahang,18,5,5,2,30,22,52,C
2018,6481,Male,Malacca,13,8,4,1,26,36,62,B
2014,6482,Male,Kedah,14,5,9,5,33,26,59,C
2013,6483,Female,Malacca,14,4,6,2,26,30,56,C
2013,6484,Female,Johor,14,8,4,5,31,40,71,B
2013,6485,Female,Malacca,15,10,4,2,31,31,62,B
2012,6486,Female,Perlis,15,9,6,3,33,22,55,C
2018,6487,Female,Penang,19,9,6,4,38,32,70,B
2015,6488,Female,Terengganu,14,4,5,5,28,38,66,B
2015,6489,Female,Malacca,21,10,5,5,41,31,72,B
2013,6490,Female,Kedah,20,5,4,1,30,31,61,B
2014,6491,Male,Sabah,21,3,9,5,38,22,60,B
2012,6492,Male,Malacca,14,6,10,1,31,39,70,B
2012,6493,Male,Negeri Sembilan,16,4,10,2,32,26,58,C
2019,6494,Female,Sarawak,17,7,8,5,37,39,76,B
2017,6495,Male,Sabah,15,8,6,3,32,35,67,B
2012,6496,Male,Perak,16,7,10,4,37,38,75,B
2016,6497,Male,Negeri Sembilan,18,9,5,5,37,22,59,C
2012,6498,Male,Sabah,17,3,5,5,30,39,69,B
2019,6499,Female,Sarawak,13,9,7,1,30,23,53,C
2014,6500,Female,Kelantan,20,9,9,3,41,31,72,B
2014,6501,Female,Pahang,14,8,7,4,33,40,73,B
2012,6502,Female,Selangor,14,9,7,2,32,37,69,B
2017,6503,Female,Penang,19,9,5,3,36,35,71,B
2012,6504,Male,Penang,21,7,3,4,35,29,64,B
2014,6505,Male,Sarawak,18,9,8,4,39,34,73,B
2012,6506,Male,Penang,21,5,5,3,34,32,66,B
2012,6507,Female,Terengganu,13,7,8,2,30,37,67,B
2017,6508,Male,Terengganu,21,4,6,1,32,33,65,B
2014,6509,Female,Perak,14,4,10,3,31,39,70,B
2012,6510,Female,Sarawak,20,4,3,4,31,26,57,C
2017,6511,Female,Terengganu,17,3,3,5,28,37,65,B
2015,6512,Male,Perlis,13,7,9,3,32,35,67,B
2014,6513,Male,Malacca,17,7,10,3,37,39,76,B
2017,6514,Female,Negeri Sembilan,18,7,3,3,31,29,60,B
2013,6515,Male,Perak,20,5,7,5,37,31,68,B
2015,6516,Female,Kelantan,18,10,8,2,38,39,77,B
2018,6517,Male,Pahang,18,6,8,5,37,34,71,B
2012,6518,Female,Kelantan,13,10,5,1,29,22,51,C
2014,6519,Male,Sarawak,16,7,9,3,35,34,69,B
2014,6520,Female,Perlis,15,3,4,1,23,40,63,B
2015,6521,Male,Malacca,16,10,5,2,33,35,68,B
2014,6522,Male,Negeri Sembilan,20,3,4,3,30,35,65,B
2019,6523,Male,Penang,18,4,3,4,29,37,66,B
2017,6524,Male,Johor,18,7,9,4,38,30,68,B
2012,6525,Female,Sarawak,15,8,5,1,29,32,61,B
2016,6526,Male,Sabah,13,3,7,5,28,25,53,C
2019,6527,Female,Kelantan,19,7,8,1,35,25,60,B
2012,6528,Female,Kelantan,15,7,9,4,35,31,66,B
2019,6529,Female,Kedah,14,9,7,5,35,25,60,B
2017,6530,Female,Negeri Sembilan,18,6,7,2,33,26,59,C
2018,6531,Female,Sabah,16,5,7,1,29,29,58,C
2019,6532,Male,Perak,16,10,7,3,36,26,62,B
2018,6533,Female,Negeri Sembilan,18,6,10,1,35,35,70,B
2017,6534,Male,Perak,18,7,7,2,34,31,65,B
2015,6535,Female,Perlis,14,10,3,4,31,29,60,B
2013,6536,Female,Negeri Sembilan,17,6,6,3,32,35,67,B
2018,6537,Female,Pahang,17,5,7,1,30,36,66,B
2018,6538,Male,Perlis,13,5,3,5,26,27,53,C
2019,6539,Female,Kelantan,15,7,10,2,34,35,69,B
2019,6540,Female,Selangor,21,6,10,5,42,28,70,B
2013,6541,Male,Kedah,14,9,3,1,27,29,56,C
2012,6542,Male,Johor,21,9,10,5,45,34,79,A
2018,6543,Female,Johor,20,3,7,4,34,24,58,C
2017,6544,Female,Perak,15,5,5,1,26,34,60,B
2019,6545,Female,Negeri Sembilan,17,5,5,5,32,38,70,B
2015,6546,Female,Sabah,17,10,8,5,40,36,76,B
2019,6547,Male,Perak,16,4,9,2,31,33,64,B
2012,6548,Male,Pahang,16,6,4,4,30,40,70,B
2013,6549,Male,Perak,14,4,8,1,27,23,50,C
2016,6550,Female,Johor,19,6,5,5,35,40,75,B
2018,6551,Female,Sarawak,17,10,10,4,41,28,69,B
2013,6552,Female,Perlis,14,9,3,1,27,26,53,C
2018,6553,Male,Kelantan,19,3,8,4,34,40,74,B
2018,6554,Male,Penang,13,3,7,5,28,29,57,C
2014,6555,Male,Perlis,19,3,7,2,31,24,55,C
2016,6556,Male,Johor,21,9,9,2,41,22,63,B
2013,6557,Male,Johor,17,10,6,3,36,34,70,B
2015,6558,Male,Selangor,17,9,4,1,31,25,56,C
2015,6559,Male,Sabah,16,8,6,4,34,28,62,B
2019,6560,Male,Johor,18,3,8,3,32,33,65,B
2019,6561,Male,Pahang,13,7,9,4,33,37,70,B
2017,6562,Male,Selangor,13,6,10,5,34,34,68,B
2015,6563,Female,Malacca,16,4,9,2,31,35,66,B
2013,6564,Female,Kedah,19,8,3,4,34,23,57,C
2012,6565,Male,Perlis,17,6,5,1,29,30,59,C
2018,6566,Female,Kedah,14,10,9,3,36,28,64,B
2016,6567,Female,Penang,15,3,6,4,28,24,52,C
2019,6568,Female,Malacca,16,8,8,1,33,22,55,C
2019,6569,Male,Perlis,20,9,6,1,36,35,71,B
2019,6570,Female,Negeri Sembilan,16,10,10,2,38,31,69,B
2012,6571,Male,Kedah,16,9,6,4,35,40,75,B
2013,6572,Female,Terengganu,14,8,9,3,34,27,61,B
2012,6573,Male,Terengganu,20,7,3,5,35,26,61,B
2018,6574,Male,Terengganu,16,3,3,3,25,33,58,C
2013,6575,Male,Malacca,19,3,4,2,28,40,68,B
2012,6576,Male,Terengganu,17,6,6,4,33,33,66,B
2017,6577,Female,Malacca,21,9,10,5,45,38,83,A
2012,6578,Female,Malacca,21,6,7,5,39,23,62,B
2017,6579,Female,Kedah,20,5,9,3,37,26,63,B
2017,6580,Male,Penang,15,6,10,3,34,36,70,B
2017,6581,Male,Perlis,17,6,4,1,28,25,53,C
2012,6582,Male,Malacca,14,8,3,4,29,33,62,B
2014,6583,Female,Sabah,19,3,4,2,28,37,65,B
2016,6584,Male,Pahang,14,9,10,3,36,31,67,B
2012,6585,Male,Malacca,19,9,6,2,36,28,64,B
2014,6586,Female,Malacca,14,10,5,2,31,39,70,B
2018,6587,Male,Penang,17,4,8,2,31,31,62,B
2013,6588,Male,Penang,15,9,7,1,32,27,59,C
2018,6589,Female,Kelantan,18,8,10,2,38,33,71,B
2014,6590,Male,Penang,13,8,3,4,28,26,54,C
2012,6591,Female,Johor,16,7,7,5,35,39,74,B
2017,6592,Female,Sabah,20,6,8,4,38,25,63,B
2017,6593,Male,Selangor,13,4,10,2,29,25,54,C
2016,6594,Male,Perlis,21,9,4,4,38,31,69,B
2017,6595,Male,Terengganu,16,5,3,2,26,23,49,F
2014,6596,Male,Negeri Sembilan,19,8,8,5,40,39,79,A
2015,6597,Female,Kedah,17,3,6,2,28,32,60,B
2018,6598,Male,Perlis,20,8,6,2,36,39,75,B
2019,6599,Female,Malacca,14,9,5,3,31,23,54,C
2014,6600,Male,Johor,20,6,5,1,32,32,64,B
2018,6601,Male,Kelantan,15,8,8,1,32,35,67,B
2017,6602,Female,Malacca,16,6,7,5,34,25,59,C
2015,6603,Female,Perlis,16,4,8,2,30,31,61,B
2013,6604,Female,Perlis,13,9,9,5,36,32,68,B
2012,6605,Female,Selangor,21,8,3,3,35,28,63,B
2013,6606,Male,Perak,20,7,9,1,37,39,76,B
2018,6607,Female,Perak,14,5,5,1,25,28,53,C
2012,6608,Male,Kedah,17,7,8,5,37,40,77,B
2014,6609,Male,Selangor,16,8,4,5,33,33,66,B
2014,6610,Female,Pahang,21,9,5,5,40,38,78,B
2012,6611,Female,Perak,17,5,6,1,29,40,69,B
2016,6612,Male,Sarawak,16,9,9,3,37,28,65,B
2015,6613,Male,Perak,13,7,7,4,31,29,60,B
2012,6614,Male,Terengganu,21,3,3,5,32,25,57,C
2012,6615,Female,Kelantan,18,10,8,1,37,23,60,B
2013,6616,Female,Sabah,16,8,7,1,32,34,66,B
2013,6617,Female,Perak,18,10,3,3,34,25,59,C
2012,6618,Male,Negeri Sembilan,18,8,9,1,36,27,63,B
2018,6619,Male,Perak,15,3,9,1,28,26,54,C
2016,6620,Female,Sabah,16,3,5,1,25,22,47,F
2014,6621,Male,Negeri Sembilan,15,6,3,2,26,24,50,C
2019,6622,Female,Selangor,18,6,5,1,30,33,63,B
2012,6623,Male,Sarawak,19,5,3,2,29,36,65,B
2017,6624,Female,Penang,18,4,7,2,31,22,53,C
2019,6625,Female,Johor,16,3,10,1,30,26,56,C
2017,6626,Male,Terengganu,17,6,8,1,32,39,71,B
2018,6627,Female,Kelantan,19,9,6,2,36,37,73,B
2018,6628,Male,Penang,16,10,8,5,39,25,64,B
2014,6629,Female,Penang,19,10,5,5,39,28,67,B
2016,6630,Male,Negeri Sembilan,20,10,7,1,38,37,75,B
2018,6631,Male,Pahang,19,4,7,1,31,37,68,B
2017,6632,Male,Negeri Sembilan,16,8,4,5,33,26,59,C
2016,6633,Female,Pahang,21,8,5,3,37,39,76,B
2018,6634,Male,Selangor,13,9,8,5,35,28,63,B
2012,6635,Male,Terengganu,19,6,5,4,34,38,72,B
2015,6636,Male,Perak,17,10,10,5,42,23,65,B
2017,6637,Male,Kedah,18,6,7,4,35,36,71,B
2017,6638,Male,Johor,19,6,3,4,32,40,72,B
2015,6639,Female,Pahang,17,6,10,4,37,37,74,B
2016,6640,Male,Perlis,18,6,3,3,30,31,61,B
2019,6641,Male,Negeri Sembilan,20,9,5,3,37,38,75,B
2017,6642,Male,Negeri Sembilan,16,10,8,5,39,22,61,B
2013,6643,Female,Kedah,21,8,5,3,37,32,69,B
2017,6644,Male,Sarawak,13,4,4,4,25,23,48,F
2014,6645,Male,Sarawak,14,7,5,5,31,27,58,C
2012,6646,Male,Kedah,17,8,8,5,38,32,70,B
2013,6647,Male,Penang,19,5,3,1,28,30,58,C
2013,6648,Female,Kelantan,13,6,7,5,31,38,69,B
2012,6649,Female,Penang,14,4,7,2,27,28,55,C
2015,6650,Female,Kedah,21,9,9,1,40,29,69,B
2012,6651,Female,Penang,19,8,4,1,32,29,61,B
2012,6652,Male,Kedah,21,7,10,4,42,31,73,B
2017,6653,Male,Pahang,13,6,9,3,31,33,64,B
2018,6654,Male,Kedah,19,6,10,1,36,23,59,C
2015,6655,Male,Perlis,20,5,5,3,33,28,61,B
2012,6656,Male,Malacca,16,6,4,2,28,28,56,C
2018,6657,Female,Malacca,16,10,7,2,35,36,71,B
2019,6658,Male,Sarawak,18,4,4,5,31,36,67,B
2017,6659,Male,Pahang,15,7,4,3,29,34,63,B
2018,6660,Female,Negeri Sembilan,19,4,10,3,36,32,68,B
2013,6661,Female,Selangor,15,7,9,1,32,31,63,B
2012,6662,Female,Kedah,18,3,5,4,30,36,66,B
2016,6663,Female,Malacca,20,5,3,1,29,34,63,B
2014,6664,Female,Penang,17,10,3,4,34,29,63,B
2013,6665,Female,Terengganu,20,7,3,2,32,29,61,B
2015,6666,Male,Penang,15,4,7,1,27,29,56,C
2019,6667,Female,Pahang,13,3,4,5,25,24,49,F
2016,6668,Female,Kelantan,21,5,6,3,35,27,62,B
2013,6669,Female,Pahang,19,9,8,1,37,24,61,B
2018,6670,Female,Sarawak,17,4,7,4,32,27,59,C
2018,6671,Female,Sarawak,19,10,6,3,38,40,78,B
2012,6672,Female,Kedah,18,9,8,3,38,24,62,B
2015,6673,Female,Perak,18,10,6,4,38,38,76,B
2017,6674,Male,Perlis,18,5,10,4,37,38,75,B
2017,6675,Male,Malacca,13,8,7,5,33,26,59,C
2016,6676,Female,Malacca,21,6,3,4,34,26,60,B
2017,6677,Male,Perak,19,5,6,5,35,26,61,B
2012,6678,Female,Kelantan,16,9,8,2,35,38,73,B
2013,6679,Male,Sabah,20,4,4,5,33,29,62,B
2017,6680,Male,Kelantan,20,4,3,3,30,26,56,C
2015,6681,Male,Sabah,21,6,6,5,38,40,78,B
2018,6682,Female,Kelantan,15,10,7,3,35,37,72,B
2017,6683,Female,Perlis,16,6,9,5,36,26,62,B
2012,6684,Male,Perak,20,8,7,4,39,26,65,B
2012,6685,Male,Malacca,19,8,4,2,33,22,55,C
2019,6686,Male,Negeri Sembilan,15,8,3,4,30,28,58,C
2019,6687,Male,Sarawak,16,9,5,3,33,28,61,B
2016,6688,Female,Penang,13,5,8,1,27,37,64,B
2012,6689,Female,Kelantan,19,4,7,2,32,40,72,B
2015,6690,Female,Sarawak,21,7,5,2,35,26,61,B
2016,6691,Male,Penang,19,6,4,3,32,33,65,B
2016,6692,Male,Pahang,13,10,9,3,35,29,64,B
2018,6693,Male,Negeri Sembilan,14,7,3,2,26,33,59,C
2017,6694,Male,Sabah,17,5,9,3,34,34,68,B
2014,6695,Male,Penang,13,7,5,4,29,30,59,C
2019,6696,Female,Sarawak,15,7,9,5,36,40,76,B
2013,6697,Male,Sarawak,14,8,10,3,35,22,57,C
2013,6698,Male,Sarawak,15,6,5,3,29,28,57,C
2017,6699,Female,Perak,21,4,8,1,34,31,65,B
2016,6700,Female,Sabah,15,3,5,1,24,27,51,C
2019,6701,Female,Penang,14,9,3,1,27,35,62,B
2017,6702,Male,Perlis,20,5,5,3,33,38,71,B
2018,6703,Male,Sarawak,14,7,6,2,29,22,51,C
2016,6704,Male,Malacca,20,6,5,5,36,36,72,B
2014,6705,Male,Negeri Sembilan,20,4,8,3,35,35,70,B
2016,6706,Female,Malacca,20,9,6,2,37,30,67,B
2018,6707,Male,Sabah,13,9,7,1,30,30,60,B
2018,6708,Male,Terengganu,13,4,6,2,25,23,48,F
2013,6709,Male,Perlis,13,5,7,2,27,37,64,B
2015,6710,Male,Terengganu,20,7,4,1,32,40,72,B
2013,6711,Male,Perlis,19,6,8,3,36,33,69,B
2016,6712,Female,Kedah,21,6,8,4,39,38,77,B
2018,6713,Male,Johor,13,7,7,1,28,40,68,B
2019,6714,Female,Negeri Sembilan,14,3,3,1,21,34,55,C
2018,6715,Male,Kedah,14,4,10,4,32,35,67,B
2018,6716,Male,Negeri Sembilan,16,8,10,3,37,27,64,B
2016,6717,Male,Sarawak,18,6,4,4,32,31,63,B
2018,6718,Female,Malacca,15,7,10,3,35,40,75,B
2019,6719,Female,Kelantan,20,3,9,5,37,38,75,B
2019,6720,Female,Pahang,14,5,4,5,28,34,62,B
2018,6721,Male,Kelantan,21,6,5,4,36,33,69,B
2012,6722,Male,Perlis,18,9,6,3,36,23,59,C
2017,6723,Female,Kedah,19,8,4,3,34,39,73,B
2019,6724,Male,Kelantan,16,9,8,4,37,30,67,B
2015,6725,Male,Sabah,16,6,6,4,32,33,65,B
2019,6726,Female,Negeri Sembilan,16,4,10,3,33,24,57,C
2019,6727,Female,Pahang,17,4,10,4,35,23,58,C
2013,6728,Female,Pahang,18,10,5,4,37,37,74,B
2014,6729,Male,Selangor,20,6,4,4,34,33,67,B
2013,6730,Male,Terengganu,19,5,9,2,35,35,70,B
2016,6731,Female,Terengganu,14,9,9,2,34,29,63,B
2012,6732,Male,Malacca,21,10,7,2,40,33,73,B
2016,6733,Male,Perlis,17,10,7,2,36,38,74,B
2014,6734,Female,Kedah,18,4,10,2,34,34,68,B
2012,6735,Male,Kedah,18,8,7,1,34,28,62,B
2012,6736,Male,Perlis,21,8,7,5,41,22,63,B
2014,6737,Male,Sabah,19,9,9,4,41,28,69,B
2015,6738,Female,Perlis,15,10,10,1,36,32,68,B
2016,6739,Female,Pahang,13,6,9,3,31,27,58,C
2013,6740,Female,Sarawak,14,8,7,2,31,33,64,B
2016,6741,Female,Pahang,16,8,8,3,35,22,57,C
2012,6742,Male,Perak,15,3,7,3,28,23,51,C
2018,6743,Male,Perlis,21,6,5,4,36,22,58,C
2013,6744,Female,Sabah,13,3,7,3,26,23,49,F
2012,6745,Male,Malacca,18,7,4,3,32,39,71,B
2015,6746,Female,Pahang,14,10,8,5,37,31,68,B
2019,6747,Male,Negeri Sembilan,20,7,9,3,39,25,64,B
2012,6748,Male,Johor,19,4,7,2,32,24,56,C
2014,6749,Female,Negeri Sembilan,20,7,10,4,41,24,65,B
2015,6750,Female,Kedah,20,8,9,2,39,36,75,B
2012,6751,Female,Malacca,16,6,3,5,30,39,69,B
2014,6752,Female,Perlis,14,10,6,3,33,28,61,B
2016,6753,Male,Sabah,16,9,9,2,36,40,76,B
2015,6754,Male,Selangor,19,10,4,1,34,24,58,C
2018,6755,Female,Johor,18,6,5,3,32,28,60,B
2016,6756,Female,Johor,18,9,3,4,34,33,67,B
2012,6757,Male,Perak,18,8,9,4,39,24,63,B
2018,6758,Female,Penang,17,3,6,3,29,32,61,B
2015,6759,Female,Kelantan,13,9,10,4,36,35,71,B
2019,6760,Female,Terengganu,17,8,3,3,31,25,56,C
2013,6761,Female,Kedah,17,8,6,1,32,24,56,C
2017,6762,Female,Penang,17,10,10,1,38,37,75,B
2012,6763,Female,Perak,16,10,10,1,37,35,72,B
2017,6764,Female,Sabah,14,9,5,1,29,28,57,C
2013,6765,Male,Perlis,14,10,9,5,38,24,62,B
2012,6766,Male,Perlis,15,9,3,5,32,34,66,B
2018,6767,Female,Sarawak,18,10,4,1,33,29,62,B
2018,6768,Male,Terengganu,18,5,10,1,34,35,69,B
2019,6769,Male,Negeri Sembilan,17,7,6,4,34,39,73,B
2017,6770,Male,Terengganu,18,4,4,3,29,26,55,C
2012,6771,Male,Kedah,13,9,4,1,27,26,53,C
2014,6772,Male,Perak,20,6,6,4,36,27,63,B
2015,6773,Female,Selangor,19,9,3,2,33,33,66,B
2018,6774,Male,Malacca,14,7,8,5,34,25,59,C
2016,6775,Male,Kedah,13,5,4,2,24,31,55,C
2015,6776,Female,Malacca,14,10,8,4,36,27,63,B
2013,6777,Male,Johor,21,9,7,5,42,25,67,B
2018,6778,Female,Perak,13,7,6,3,29,34,63,B
2019,6779,Male,Terengganu,13,4,9,5,31,37,68,B
2018,6780,Male,Perlis,14,5,3,5,27,25,52,C
2019,6781,Male,Perak,13,5,9,5,32,38,70,B
2014,6782,Female,Terengganu,18,8,8,1,35,38,73,B
2015,6783,Male,Selangor,19,7,8,4,38,25,63,B
2019,6784,Male,Malacca,19,3,5,2,29,33,62,B
2014,6785,Female,Sarawak,20,4,8,1,33,37,70,B
2017,6786,Female,Terengganu,16,6,8,3,33,22,55,C
2014,6787,Female,Malacca,15,7,4,5,31,33,64,B
2016,6788,Female,Selangor,20,9,9,5,43,37,80,A
2016,6789,Male,Negeri Sembilan,21,10,8,2,41,32,73,B
2013,6790,Male,Selangor,17,4,3,1,25,34,59,C
2016,6791,Female,Perak,18,5,6,2,31,35,66,B
2015,6792,Male,Sarawak,16,5,8,4,33,39,72,B
2017,6793,Male,Sarawak,16,10,3,1,30,24,54,C
2018,6794,Female,Selangor,16,9,8,1,34,30,64,B
2014,6795,Male,Sarawak,21,4,3,5,33,25,58,C
2017,6796,Female,Selangor,16,9,10,2,37,31,68,B
2014,6797,Female,Kedah,19,3,3,1,26,28,54,C
2016,6798,Female,Kedah,13,8,5,4,30,22,52,C
2018,6799,Male,Negeri Sembilan,15,9,6,1,31,30,61,B
2018,6800,Female,Malacca,19,8,3,5,35,23,58,C
2012,6801,Female,Sarawak,16,3,9,3,31,27,58,C
2017,6802,Female,Perak,16,7,4,1,28,35,63,B
2015,6803,Male,Penang,13,7,8,1,29,25,54,C
2016,6804,Male,Penang,21,3,4,2,30,25,55,C
2014,6805,Male,Malacca,15,9,5,2,31,35,66,B
2017,6806,Male,Malacca,19,8,4,1,32,27,59,C
2012,6807,Male,Kelantan,16,5,4,4,29,32,61,B
2018,6808,Female,Penang,18,10,4,2,34,34,68,B
2018,6809,Female,Kedah,18,7,8,4,37,35,72,B
2016,6810,Male,Perlis,13,8,6,1,28,24,52,C
2018,6811,Female,Sarawak,21,8,3,2,34,37,71,B
2018,6812,Female,Kelantan,19,3,10,3,35,37,72,B
2012,6813,Male,Kedah,19,3,6,3,31,26,57,C
2018,6814,Male,Sarawak,15,4,10,3,32,30,62,B
2017,6815,Female,Malacca,17,9,9,2,37,38,75,B
2015,6816,Female,Selangor,18,8,7,1,34,23,57,C
2019,6817,Male,Sabah,16,8,4,1,29,35,64,B
2018,6818,Male,Perlis,20,4,10,2,36,39,75,B
2012,6819,Female,Pahang,15,5,3,4,27,23,50,C
2018,6820,Male,Perak,15,3,4,5,27,39,66,B
2018,6821,Male,Negeri Sembilan,16,10,10,5,41,34,75,B
2012,6822,Female,Kedah,15,8,10,5,38,22,60,B
2014,6823,Male,Kedah,14,10,10,5,39,39,78,B
2012,6824,Male,Malacca,19,8,9,4,40,30,70,B
2017,6825,Male,Malacca,20,5,6,3,34,32,66,B
2013,6826,Male,Perak,19,6,6,4,35,23,58,C
2018,6827,Male,Kedah,14,3,6,1,24,40,64,B
2018,6828,Male,Perak,13,3,8,2,26,28,54,C
2019,6829,Male,Perak,21,8,4,4,37,40,77,B
2017,6830,Female,Perlis,14,8,4,2,28,22,50,C
2019,6831,Male,Kedah,15,10,10,3,38,30,68,B
2014,6832,Male,Selangor,19,4,7,3,33,38,71,B
2016,6833,Male,Sarawak,17,6,10,3,36,31,67,B
2016,6834,Male,Pahang,13,5,5,2,25,27,52,C
2019,6835,Female,Terengganu,13,3,7,4,27,28,55,C
2015,6836,Male,Johor,18,3,4,2,27,34,61,B
2017,6837,Female,Sabah,20,8,6,5,39,37,76,B
2018,6838,Male,Pahang,18,9,8,3,38,33,71,B
2016,6839,Male,Kedah,19,6,3,1,29,30,59,C
2015,6840,Female,Negeri Sembilan,14,4,8,1,27,35,62,B
2012,6841,Female,Pahang,21,3,9,1,34,23,57,C
2012,6842,Female,Negeri Sembilan,19,10,5,5,39,23,62,B
2012,6843,Male,Sabah,15,7,5,2,29,32,61,B
2015,6844,Female,Johor,13,4,5,2,24,38,62,B
2018,6845,Male,Negeri Sembilan,17,6,6,5,34,34,68,B
2014,6846,Male,Selangor,15,9,9,5,38,34,72,B
2015,6847,Male,Penang,16,6,5,2,29,36,65,B
2013,6848,Female,Perak,20,5,6,3,34,30,64,B
2016,6849,Female,Kelantan,21,6,5,3,35,38,73,B
2012,6850,Female,Johor,17,4,4,1,26,34,60,B
2015,6851,Male,Malacca,14,10,4,1,29,33,62,B
2014,6852,Female,Johor,18,7,7,5,37,40,77,B
2018,6853,Female,Kedah,13,3,3,4,23,31,54,C
2018,6854,Male,Sarawak,20,3,5,2,30,27,57,C
2013,6855,Male,Kelantan,14,3,8,1,26,29,55,C
2012,6856,Female,Sarawak,19,4,6,3,32,32,64,B
2014,6857,Male,Malacca,14,3,5,4,26,40,66,B
2013,6858,Female,Terengganu,20,10,10,2,42,40,82,A
2012,6859,Female,Johor,21,10,9,3,43,25,68,B
2015,6860,Female,Johor,13,7,9,4,33,33,66,B
2016,6861,Female,Kedah,18,9,6,5,38,39,77,B
2012,6862,Female,Kedah,15,9,7,5,36,38,74,B
2016,6863,Male,Perak,20,5,8,3,36,39,75,B
2015,6864,Male,Perak,14,3,3,3,23,40,63,B
2017,6865,Male,Selangor,21,6,5,3,35,22,57,C
2012,6866,Female,Malacca,18,5,5,1,29,28,57,C
2016,6867,Male,Perak,20,6,4,2,32,35,67,B
2019,6868,Male,Terengganu,17,5,3,2,27,31,58,C
2016,6869,Female,Negeri Sembilan,13,9,4,2,28,40,68,B
2013,6870,Female,Kelantan,15,9,5,3,32,38,70,B
2018,6871,Male,Pahang,19,3,3,5,30,24,54,C
2014,6872,Female,Negeri Sembilan,21,3,3,2,29,27,56,C
2018,6873,Male,Negeri Sembilan,18,6,8,5,37,40,77,B
2013,6874,Male,Negeri Sembilan,15,3,9,1,28,26,54,C
2012,6875,Female,Pahang,16,3,6,1,26,32,58,C
2018,6876,Female,Kelantan,13,10,5,1,29,22,51,C
2016,6877,Male,Kelantan,14,5,5,2,26,24,50,C
2014,6878,Female,Johor,14,6,10,1,31,34,65,B
2017,6879,Female,Sabah,13,7,6,3,29,37,66,B
2016,6880,Female,Sabah,19,8,9,3,39,26,65,B
2016,6881,Female,Selangor,16,8,5,2,31,29,60,B
2018,6882,Female,Kelantan,15,5,10,1,31,26,57,C
2014,6883,Male,Kelantan,21,10,3,1,35,32,67,B
2016,6884,Female,Sabah,19,8,5,1,33,33,66,B
2015,6885,Male,Johor,15,9,5,5,34,23,57,C
2016,6886,Female,Penang,21,8,7,5,41,24,65,B
2012,6887,Female,Malacca,15,3,4,1,23,28,51,C
2016,6888,Male,Sarawak,18,5,6,2,31,31,62,B
2017,6889,Male,Penang,18,8,7,1,34,23,57,C
2019,6890,Female,Sarawak,17,7,4,5,33,36,69,B
2012,6891,Female,Johor,16,5,9,4,34,25,59,C
2018,6892,Female,Sabah,21,4,10,5,40,35,75,B
2017,6893,Female,Sabah,21,3,5,1,30,35,65,B
2018,6894,Female,Terengganu,16,6,6,2,30,28,58,C
2012,6895,Female,Perak,21,9,5,5,40,40,80,A
2014,6896,Female,Johor,14,7,7,1,29,23,52,C
2019,6897,Male,Johor,17,6,6,4,33,26,59,C
2015,6898,Male,Malacca,21,6,6,4,37,24,61,B
2018,6899,Female,Negeri Sembilan,19,5,9,3,36,31,67,B
2016,6900,Female,Penang,20,10,7,4,41,32,73,B
2018,6901,Female,Kedah,19,8,7,5,39,24,63,B
2016,6902,Male,Johor,19,5,8,5,37,32,69,B
2012,6903,Female,Kelantan,21,8,4,3,36,38,74,B
2017,6904,Male,Kelantan,21,6,10,5,42,31,73,B
2018,6905,Female,Malacca,20,5,6,5,36,35,71,B
2013,6906,Male,Penang,17,9,10,4,40,40,80,A
2015,6907,Female,Sabah,16,10,6,1,33,22,55,C
2014,6908,Male,Penang,14,7,4,4,29,32,61,B
2015,6909,Female,Penang,17,7,6,1,31,26,57,C
2012,6910,Male,Johor,17,5,3,5,30,27,57,C
2018,6911,Female,Negeri Sembilan,18,7,3,2,30,30,60,B
2019,6912,Female,Sabah,14,6,4,2,26,37,63,B
2019,6913,Male,Penang,17,7,8,2,34,23,57,C
2016,6914,Male,Negeri Sembilan,15,7,10,2,34,30,64,B
2019,6915,Female,Terengganu,15,9,10,4,38,23,61,B
2017,6916,Male,Negeri Sembilan,15,4,7,5,31,39,70,B
2015,6917,Male,Selangor,14,9,7,4,34,38,72,B
2014,6918,Male,Johor,21,3,3,3,30,29,59,C
2016,6919,Male,Kedah,20,10,3,4,37,28,65,B
2019,6920,Female,Perlis,21,9,8,1,39,31,70,B
2018,6921,Male,Penang,19,6,7,3,35,32,67,B
2016,6922,Female,Pahang,19,4,3,5,31,35,66,B
2014,6923,Female,Perlis,13,5,9,1,28,38,66,B
2019,6924,Female,Sabah,19,9,7,4,39,31,70,B
2012,6925,Male,Terengganu,16,3,9,3,31,39,70,B
2017,6926,Male,Negeri Sembilan,20,9,6,3,38,40,78,B
2015,6927,Male,Perak,16,8,8,4,36,22,58,C
2018,6928,Male,Johor,13,8,3,3,27,28,55,C
2012,6929,Female,Penang,16,8,4,1,29,31,60,B
2015,6930,Female,Perak,18,3,10,2,33,39,72,B
2014,6931,Female,Selangor,14,8,6,5,33,26,59,C
2017,6932,Female,Terengganu,20,3,4,3,30,24,54,C
2015,6933,Female,Terengganu,17,8,3,4,32,37,69,B
2012,6934,Male,Johor,15,8,3,5,31,39,70,B
2017,6935,Male,Terengganu,19,7,3,3,32,33,65,B
2014,6936,Female,Johor,20,10,7,2,39,27,66,B
2015,6937,Male,Perak,13,4,3,2,22,29,51,C
2015,6938,Female,Perlis,17,8,3,5,33,33,66,B
2014,6939,Male,Sabah,19,9,5,2,35,29,64,B
2018,6940,Male,Selangor,21,9,7,3,40,31,71,B
2014,6941,Male,Perlis,19,4,10,4,37,31,68,B
2018,6942,Male,Sabah,13,3,9,1,26,38,64,B
2018,6943,Male,Kelantan,20,10,10,4,44,28,72,B
2017,6944,Male,Malacca,18,7,6,4,35,31,66,B
2017,6945,Female,Pahang,16,3,8,1,28,37,65,B
2018,6946,Female,Penang,14,10,7,4,35,36,71,B
2014,6947,Female,Malacca,17,5,4,1,27,37,64,B
2012,6948,Female,Johor,13,7,10,1,31,23,54,C
2015,6949,Female,Perlis,17,10,3,5,35,27,62,B
2016,6950,Female,Kelantan,17,3,6,5,31,35,66,B
2012,6951,Female,Sarawak,19,5,9,5,38,23,61,B
2018,6952,Female,Selangor,19,4,10,1,34,38,72,B
2014,6953,Male,Kelantan,15,7,8,5,35,35,70,B
2013,6954,Male,Perlis,17,7,5,4,33,36,69,B
2015,6955,Male,Malacca,14,6,5,2,27,31,58,C
2016,6956,Male,Terengganu,13,9,6,2,30,26,56,C
2017,6957,Female,Terengganu,16,3,3,5,27,30,57,C
2014,6958,Male,Kelantan,18,3,4,4,29,38,67,B
2015,6959,Female,Penang,16,6,8,4,34,23,57,C
2017,6960,Male,Selangor,14,5,6,2,27,28,55,C
2019,6961,Male,Pahang,15,3,3,4,25,36,61,B
2012,6962,Male,Perlis,15,7,5,2,29,22,51,C
2019,6963,Male,Pahang,14,4,3,1,22,27,49,F
2017,6964,Female,Pahang,18,10,8,3,39,28,67,B
2016,6965,Male,Malacca,17,4,5,5,31,26,57,C
2013,6966,Female,Terengganu,21,5,7,4,37,30,67,B
2018,6967,Male,Selangor,17,3,5,1,26,40,66,B
2015,6968,Male,Malacca,19,4,4,1,28,24,52,C
2015,6969,Male,Malacca,16,10,3,5,34,27,61,B
2019,6970,Female,Perlis,14,3,4,1,22,35,57,C
2013,6971,Female,Perlis,16,6,7,2,31,33,64,B
2015,6972,Female,Johor,18,3,10,5,36,40,76,B
2017,6973,Female,Kelantan,15,9,6,1,31,37,68,B
2017,6974,Male,Terengganu,19,7,4,1,31,26,57,C
2019,6975,Male,Malacca,21,9,4,3,37,40,77,B
2018,6976,Male,Johor,18,3,8,3,32,27,59,C
2018,6977,Male,Johor,19,8,3,5,35,38,73,B
2016,6978,Female,Kedah,19,10,8,5,42,28,70,B
2017,6979,Female,Pahang,18,7,9,4,38,23,61,B
2017,6980,Female,Selangor,13,6,10,4,33,35,68,B
2017,6981,Male,Kelantan,18,10,8,1,37,34,71,B
2016,6982,Female,Selangor,14,6,3,1,24,40,64,B
2018,6983,Male,Johor,14,5,10,2,31,25,56,C
2015,6984,Male,Negeri Sembilan,18,5,5,4,32,32,64,B
2018,6985,Male,Sabah,21,3,8,5,37,36,73,B
2012,6986,Male,Perak,13,6,8,4,31,35,66,B
2017,6987,Male,Kedah,18,10,8,3,39,27,66,B
2012,6988,Female,Pahang,21,8,5,1,35,31,66,B
2017,6989,Male,Negeri Sembilan,16,10,9,3,38,29,67,B
2017,6990,Male,Selangor,15,3,7,5,30,23,53,C
2017,6991,Female,Negeri Sembilan,14,8,4,2,28,22,50,C
2012,6992,Female,Negeri Sembilan,18,9,7,5,39,29,68,B
2012,6993,Male,Johor,19,6,5,2,32,23,55,C
2013,6994,Female,Kedah,19,8,6,2,35,30,65,B
2013,6995,Female,Kedah,21,8,7,2,38,35,73,B
2014,6996,Female,Sabah,13,4,6,4,27,35,62,B
2015,6997,Male,Perak,20,4,10,5,39,29,68,B
2012,6998,Male,Perak,14,3,6,3,26,27,53,C
2018,6999,Male,Sarawak,19,6,10,4,39,35,74,B
2015,7000,Female,Penang,18,3,9,3,33,22,55,C
2013,7001,Male,Perak,14,6,10,1,31,26,57,C
2015,7002,Female,Terengganu,20,3,3,1,27,33,60,B
2012,7003,Female,Sarawak,20,7,5,3,35,39,74,B
2016,7004,Female,Malacca,20,8,7,3,38,39,77,B
2016,7005,Female,Kedah,13,9,6,4,32,26,58,C
2012,7006,Female,Johor,19,5,3,2,29,32,61,B
2012,7007,Male,Penang,18,3,9,1,31,28,59,C
2019,7008,Female,Malacca,18,7,8,1,34,28,62,B
2015,7009,Female,Perak,17,7,10,5,39,39,78,B
2014,7010,Female,Perak,17,5,7,2,31,27,58,C
2013,7011,Female,Perlis,19,7,8,2,36,24,60,B
2019,7012,Male,Malacca,18,4,3,5,30,40,70,B
2013,7013,Female,Johor,18,7,7,2,34,36,70,B
2016,7014,Male,Terengganu,18,3,4,1,26,27,53,C
2017,7015,Male,Johor,17,9,6,4,36,32,68,B
2018,7016,Male,Johor,17,8,10,3,38,40,78,B
2019,7017,Female,Perak,21,6,3,5,35,23,58,C
2019,7018,Female,Penang,18,6,7,5,36,26,62,B
2012,7019,Female,Kelantan,14,6,6,4,30,29,59,C
2016,7020,Female,Malacca,20,9,9,5,43,40,83,A
2012,7021,Male,Perlis,21,6,3,3,33,25,58,C
2013,7022,Female,Selangor,18,10,4,2,34,29,63,B
2014,7023,Female,Terengganu,14,5,9,4,32,32,64,B
2012,7024,Male,Kedah,17,6,9,4,36,26,62,B
2018,7025,Male,Pahang,21,6,5,5,37,22,59,C
2019,7026,Male,Sabah,19,10,4,2,35,24,59,C
2018,7027,Female,Sabah,17,4,8,4,33,23,56,C
2013,7028,Female,Johor,20,4,7,1,32,32,64,B
2018,7029,Female,Penang,17,8,4,1,30,38,68,B
2012,7030,Male,Perak,16,7,3,1,27,25,52,C
2016,7031,Female,Penang,20,10,6,2,38,22,60,B
2012,7032,Female,Sarawak,13,9,8,4,34,26,60,B
2017,7033,Male,Penang,16,7,4,3,30,29,59,C
2016,7034,Male,Sabah,18,10,7,4,39,37,76,B
2019,7035,Male,Kelantan,13,4,7,3,27,37,64,B
2014,7036,Male,Johor,18,4,4,4,30,33,63,B
2014,7037,Female,Perlis,17,5,8,2,32,33,65,B
2016,7038,Female,Penang,13,10,4,4,31,32,63,B
2015,7039,Female,Malacca,13,8,9,3,33,23,56,C
2018,7040,Male,Sarawak,16,9,7,5,37,35,72,B
2018,7041,Male,Pahang,14,10,7,5,36,30,66,B
2017,7042,Male,Sabah,19,8,5,5,37,24,61,B
2012,7043,Female,Pahang,18,8,10,5,41,39,80,A
2014,7044,Female,Kelantan,21,7,9,3,40,34,74,B
2012,7045,Male,Sarawak,15,3,10,5,33,23,56,C
2013,7046,Male,Pahang,13,5,3,2,23,37,60,B
2013,7047,Male,Sarawak,18,7,7,4,36,22,58,C
2015,7048,Male,Negeri Sembilan,19,9,5,2,35,29,64,B
2019,7049,Female,Perlis,20,5,3,2,30,24,54,C
2014,7050,Male,Negeri Sembilan,18,6,3,5,32,39,71,B
2013,7051,Male,Kedah,16,10,6,4,36,26,62,B
2015,7052,Male,Perlis,18,9,6,3,36,34,70,B
2019,7053,Male,Johor,21,10,9,4,44,27,71,B
2018,7054,Female,Terengganu,17,10,7,2,36,26,62,B
2013,7055,Female,Terengganu,19,10,9,1,39,28,67,B
2013,7056,Female,Kedah,19,7,9,2,37,40,77,B
2019,7057,Female,Penang,18,10,9,1,38,40,78,B
2019,7058,Male,Malacca,17,7,7,3,34,26,60,B
2012,7059,Female,Kedah,21,10,5,1,37,22,59,C
2012,7060,Male,Negeri Sembilan,13,7,6,3,29,22,51,C
2013,7061,Female,Kelantan,20,7,5,5,37,35,72,B
2014,7062,Male,Terengganu,14,3,10,5,32,31,63,B
2018,7063,Female,Selangor,13,3,9,3,28,33,61,B
2018,7064,Male,Malacca,20,6,8,3,37,27,64,B
2013,7065,Female,Negeri Sembilan,15,8,4,1,28,33,61,B
2014,7066,Male,Pahang,21,7,9,5,42,37,79,A
2018,7067,Female,Penang,18,5,6,4,33,36,69,B
2017,7068,Male,Malacca,19,9,9,2,39,26,65,B
2018,7069,Male,Sabah,19,5,4,2,30,22,52,C
2018,7070,Male,Perak,20,3,10,5,38,40,78,B
2012,7071,Female,Perak,19,3,5,1,28,40,68,B
2012,7072,Female,Kelantan,16,8,8,4,36,36,72,B
2017,7073,Male,Johor,13,3,4,2,22,38,60,B
2013,7074,Female,Malacca,15,9,8,3,35,31,66,B
2017,7075,Male,Selangor,13,3,10,4,30,31,61,B
2013,7076,Female,Malacca,15,9,9,4,37,29,66,B
2013,7077,Female,Penang,19,7,3,2,31,33,64,B
2015,7078,Female,Johor,19,6,10,1,36,25,61,B
2013,7079,Male,Penang,18,8,5,5,36,26,62,B
2013,7080,Female,Pahang,18,3,3,5,29,40,69,B
2015,7081,Female,Johor,13,4,5,2,24,34,58,C
2018,7082,Male,Terengganu,14,3,10,1,28,26,54,C
2013,7083,Male,Sarawak,21,4,7,2,34,40,74,B
2016,7084,Male,Johor,20,6,10,4,40,25,65,B
2017,7085,Female,Perak,13,7,6,5,31,24,55,C
2019,7086,Male,Terengganu,15,8,9,1,33,29,62,B
2015,7087,Male,Pahang,19,8,9,3,39,29,68,B
2018,7088,Male,Sabah,16,5,9,4,34,32,66,B
2016,7089,Male,Penang,14,6,8,3,31,33,64,B
2017,7090,Female,Sabah,17,5,5,3,30,35,65,B
2013,7091,Female,Terengganu,18,9,9,4,40,28,68,B
2014,7092,Male,Negeri Sembilan,13,4,3,2,22,25,47,F
2018,7093,Female,Penang,19,8,7,4,38,29,67,B
2013,7094,Female,Penang,13,10,9,4,36,25,61,B
2017,7095,Male,Perlis,20,6,3,1,30,24,54,C
2015,7096,Female,Pahang,18,10,5,4,37,27,64,B
2016,7097,Female,Kedah,20,7,10,4,41,33,74,B
2012,7098,Female,Malacca,14,7,6,3,30,29,59,C
2016,7099,Female,Sabah,20,10,10,3,43,33,76,B
2016,7100,Male,Penang,17,9,6,5,37,34,71,B
2013,7101,Male,Sabah,16,6,6,4,32,26,58,C
2016,7102,Male,Penang,17,5,8,5,35,36,71,B
2015,7103,Female,Malacca,20,9,6,4,39,39,78,B
2013,7104,Male,Pahang,20,3,9,1,33,31,64,B
2013,7105,Male,Penang,16,3,6,4,29,34,63,B
2013,7106,Female,Sarawak,18,5,8,1,32,25,57,C
2019,7107,Male,Terengganu,15,5,10,2,32,33,65,B
2014,7108,Female,Kelantan,16,7,4,2,29,34,63,B
2017,7109,Male,Selangor,18,8,7,3,36,31,67,B
2018,7110,Male,Kedah,14,9,5,2,30,22,52,C
2019,7111,Male,Sabah,20,8,5,2,35,32,67,B
2014,7112,Male,Sarawak,17,6,9,3,35,29,64,B
2015,7113,Male,Perlis,18,8,5,2,33,39,72,B
2013,7114,Female,Kelantan,18,9,3,1,31,36,67,B
2016,7115,Female,Penang,18,5,10,4,37,25,62,B
2017,7116,Male,Malacca,19,3,6,3,31,36,67,B
2015,7117,Female,Sabah,13,10,8,5,36,40,76,B
2012,7118,Male,Pahang,15,5,8,3,31,25,56,C
2012,7119,Female,Penang,21,10,3,4,38,28,66,B
2013,7120,Female,Penang,13,7,7,5,32,27,59,C
2014,7121,Male,Perlis,19,4,8,4,35,25,60,B
2013,7122,Female,Perlis,18,7,5,5,35,39,74,B
2019,7123,Male,Selangor,20,6,9,5,40,34,74,B
2012,7124,Female,Malacca,16,6,7,4,33,23,56,C
2014,7125,Female,Sarawak,16,10,10,2,38,33,71,B
2018,7126,Male,Kelantan,15,3,8,5,31,35,66,B
2015,7127,Male,Negeri Sembilan,20,9,8,3,40,27,67,B
2014,7128,Male,Terengganu,20,7,9,5,41,25,66,B
2017,7129,Female,Perlis,15,7,7,5,34,27,61,B
2013,7130,Male,Kedah,15,7,5,5,32,32,64,B
2015,7131,Male,Negeri Sembilan,14,3,4,2,23,38,61,B
2014,7132,Male,Pahang,15,3,3,1,22,35,57,C
2014,7133,Male,Sabah,18,7,8,3,36,40,76,B
2019,7134,Male,Sarawak,13,5,8,1,27,31,58,C
2016,7135,Male,Sarawak,17,3,7,2,29,40,69,B
2012,7136,Female,Pahang,17,10,8,1,36,25,61,B
2015,7137,Female,Terengganu,14,8,7,5,34,27,61,B
2015,7138,Female,Kedah,21,9,3,2,35,25,60,B
2012,7139,Male,Malacca,19,5,10,2,36,39,75,B
2019,7140,Male,Terengganu,20,10,6,2,38,33,71,B
2012,7141,Female,Kedah,14,3,5,5,27,25,52,C
2019,7142,Female,Selangor,14,9,6,5,34,24,58,C
2014,7143,Female,Kelantan,17,5,7,2,31,29,60,B
2015,7144,Male,Kedah,15,10,9,1,35,25,60,B
2017,7145,Female,Kedah,13,7,3,2,25,38,63,B
2016,7146,Male,Johor,15,10,3,4,32,32,64,B
2015,7147,Female,Selangor,15,4,9,4,32,30,62,B
2013,7148,Male,Perak,13,3,8,4,28,36,64,B
2012,7149,Male,Johor,15,4,3,2,24,38,62,B
2013,7150,Female,Johor,16,3,8,4,31,38,69,B
2012,7151,Male,Pahang,20,3,10,1,34,28,62,B
2013,7152,Female,Malacca,20,5,6,3,34,22,56,C
2013,7153,Male,Penang,17,5,3,3,28,24,52,C
2012,7154,Male,Selangor,13,3,7,3,26,40,66,B
2012,7155,Male,Johor,17,10,3,3,33,36,69,B
2018,7156,Female,Penang,17,8,7,1,33,26,59,C
2016,7157,Female,Johor,14,4,3,2,23,35,58,C
2018,7158,Female,Penang,16,9,6,1,32,36,68,B
2015,7159,Male,Negeri Sembilan,19,9,7,1,36,38,74,B
2013,7160,Male,Selangor,13,10,3,5,31,28,59,C
2019,7161,Male,Perlis,21,8,5,4,38,37,75,B
2014,7162,Female,Kelantan,13,8,9,3,33,33,66,B
2013,7163,Male,Sarawak,20,4,5,4,33,36,69,B
2017,7164,Male,Johor,15,6,6,4,31,26,57,C
2019,7165,Female,Johor,15,3,5,1,24,32,56,C
2016,7166,Female,Penang,14,9,7,2,32,30,62,B
2012,7167,Male,Kelantan,15,9,5,1,30,31,61,B
2016,7168,Male,Kedah,13,4,3,1,21,23,44,F
2016,7169,Female,Perlis,19,7,4,4,34,26,60,B
2019,7170,Male,Penang,13,5,9,2,29,29,58,C
2019,7171,Female,Penang,20,6,10,4,40,26,66,B
2019,7172,Male,Penang,14,8,8,2,32,24,56,C
2017,7173,Male,Kedah,21,7,9,1,38,25,63,B
2018,7174,Male,Negeri Sembilan,18,4,3,1,26,39,65,B
2019,7175,Male,Negeri Sembilan,18,5,7,2,32,33,65,B
2019,7176,Male,Perak,13,6,9,5,33,33,66,B
2012,7177,Female,Kelantan,15,3,6,4,28,28,56,C
2016,7178,Female,Sarawak,17,5,4,5,31,24,55,C
2018,7179,Male,Penang,15,9,8,3,35,22,57,C
2017,7180,Male,Malacca,13,4,3,5,25,30,55,C
2018,7181,Female,Sarawak,17,6,6,2,31,33,64,B
2018,7182,Female,Perlis,16,10,6,5,37,34,71,B
2019,7183,Male,Sabah,13,6,5,2,26,39,65,B
2013,7184,Male,Kelantan,18,7,6,1,32,29,61,B
2012,7185,Male,Negeri Sembilan,16,7,10,1,34,27,61,B
2015,7186,Female,Johor,14,9,8,4,35,34,69,B
2018,7187,Male,Johor,21,6,3,1,31,33,64,B
2012,7188,Female,Malacca,21,6,9,1,37,34,71,B
2012,7189,Female,Penang,18,6,9,2,35,37,72,B
2019,7190,Male,Selangor,20,10,8,1,39,40,79,A
2019,7191,Female,Negeri Sembilan,14,6,3,2,25,31,56,C
2012,7192,Female,Malacca,21,9,4,1,35,34,69,B
2013,7193,Female,Perak,19,3,10,4,36,26,62,B
2013,7194,Female,Penang,14,10,10,2,36,22,58,C
2018,7195,Male,Perlis,20,3,5,3,31,30,61,B
2018,7196,Female,Pahang,16,6,8,3,33,34,67,B
2012,7197,Male,Terengganu,17,5,5,2,29,37,66,B
2016,7198,Female,Sarawak,19,8,10,1,38,38,76,B
2019,7199,Male,Kedah,20,4,8,3,35,37,72,B
2016,7200,Female,Penang,15,9,6,3,33,23,56,C
2018,7201,Female,Selangor,21,9,5,1,36,29,65,B
2013,7202,Male,Selangor,17,10,9,4,40,36,76,B
2013,7203,Male,Penang,19,9,8,5,41,24,65,B
2013,7204,Male,Sabah,20,3,9,5,37,39,76,B
2015,7205,Female,Kedah,19,10,8,3,40,32,72,B
2015,7206,Female,Pahang,18,7,10,3,38,23,61,B
2012,7207,Male,Negeri Sembilan,15,10,5,5,35,40,75,B
2018,7208,Male,Selangor,21,10,9,2,42,22,64,B
2012,7209,Female,Kedah,17,7,3,4,31,23,54,C
2015,7210,Male,Negeri Sembilan,17,8,8,1,34,22,56,C
2012,7211,Male,Perak,21,5,8,4,38,26,64,B
2018,7212,Female,Sabah,15,4,5,3,27,22,49,F
2014,7213,Female,Johor,17,6,4,3,30,34,64,B
2017,7214,Male,Negeri Sembilan,13,10,5,5,33,35,68,B
2017,7215,Male,Malacca,19,3,3,5,30,28,58,C
2013,7216,Male,Malacca,16,7,8,4,35,39,74,B
2014,7217,Female,Perlis,14,4,4,1,23,31,54,C
2019,7218,Male,Terengganu,13,9,9,5,36,26,62,B
2019,7219,Male,Sabah,20,5,3,2,30,38,68,B
2013,7220,Female,Negeri Sembilan,18,10,7,2,37,32,69,B
2018,7221,Female,Pahang,13,6,3,1,23,25,48,F
2015,7222,Male,Perak,15,7,5,3,30,30,60,B
2018,7223,Male,Sarawak,18,8,7,1,34,26,60,B
2018,7224,Male,Kelantan,18,3,7,4,32,25,57,C
2013,7225,Female,Johor,16,6,3,1,26,28,54,C
2014,7226,Female,Terengganu,20,9,5,2,36,30,66,B
2019,7227,Male,Pahang,13,5,7,4,29,25,54,C
2016,7228,Male,Kelantan,16,5,8,2,31,39,70,B
2013,7229,Male,Sarawak,18,4,7,3,32,39,71,B
2019,7230,Male,Kedah,20,3,3,4,30,24,54,C
2012,7231,Male,Selangor,17,6,7,2,32,33,65,B
2019,7232,Female,Malacca,15,7,8,2,32,35,67,B
2013,7233,Female,Selangor,15,4,3,3,25,29,54,C
2015,7234,Male,Penang,18,9,3,3,33,34,67,B
2017,7235,Female,Selangor,13,8,5,1,27,29,56,C
2019,7236,Male,Pahang,17,10,10,2,39,29,68,B
2016,7237,Male,Perak,19,3,6,2,30,35,65,B
2015,7238,Male,Johor,15,8,5,4,32,35,67,B
2016,7239,Male,Selangor,16,4,7,4,31,36,67,B
2017,7240,Male,Selangor,15,6,7,3,31,35,66,B
2014,7241,Male,Perak,17,5,4,4,30,33,63,B
2017,7242,Female,Penang,19,8,5,5,37,30,67,B
2017,7243,Female,Pahang,21,8,3,1,33,34,67,B
2019,7244,Male,Sabah,18,10,3,5,36,39,75,B
2013,7245,Male,Pahang,20,3,6,5,34,40,74,B
2012,7246,Female,Terengganu,20,8,3,5,36,40,76,B
2014,7247,Female,Kedah,18,4,3,2,27,40,67,B
2019,7248,Female,Sarawak,20,3,6,4,33,24,57,C
2018,7249,Male,Terengganu,20,9,7,5,41,36,77,B
2013,7250,Female,Johor,17,9,4,1,31,32,63,B
2019,7251,Female,Malacca,19,7,6,4,36,29,65,B
2019,7252,Male,Negeri Sembilan,21,8,4,4,37,26,63,B
2015,7253,Male,Terengganu,19,9,10,3,41,28,69,B
2013,7254,Female,Penang,20,4,5,3,32,28,60,B
2016,7255,Male,Kelantan,16,4,5,1,26,38,64,B
2016,7256,Male,Perak,19,4,4,2,29,35,64,B
2012,7257,Male,Sarawak,20,7,4,4,35,36,71,B
2012,7258,Female,Malacca,17,3,10,2,32,36,68,B
2013,7259,Female,Negeri Sembilan,14,6,10,4,34,33,67,B
2017,7260,Male,Selangor,20,6,8,1,35,33,68,B
2012,7261,Male,Malacca,14,5,4,5,28,28,56,C
2014,7262,Female,Terengganu,17,10,3,2,32,24,56,C
2013,7263,Male,Selangor,21,5,5,3,34,31,65,B
2012,7264,Female,Kelantan,14,6,10,5,35,29,64,B
2012,7265,Male,Kedah,14,9,4,1,28,28,56,C
2016,7266,Female,Pahang,17,9,8,2,36,27,63,B
2014,7267,Female,Penang,18,10,4,4,36,23,59,C
2018,7268,Male,Perlis,15,9,7,1,32,32,64,B
2012,7269,Male,Terengganu,15,6,3,1,25,30,55,C
2012,7270,Female,Pahang,13,9,10,3,35,29,64,B
2015,7271,Male,Perlis,18,5,6,5,34,23,57,C
2013,7272,Male,Perlis,20,3,7,4,34,24,58,C
2019,7273,Male,Pahang,14,7,7,4,32,32,64,B
2012,7274,Female,Kedah,21,8,9,4,42,24,66,B
2017,7275,Female,Kelantan,17,9,7,4,37,30,67,B
2016,7276,Female,Negeri Sembilan,20,9,7,3,39,22,61,B
2014,7277,Female,Kelantan,16,3,3,1,23,29,52,C
2013,7278,Male,Negeri Sembilan,20,10,10,3,43,38,81,A
2014,7279,Female,Negeri Sembilan,16,3,6,5,30,26,56,C
2016,7280,Male,Negeri Sembilan,16,4,9,5,34,33,67,B
2013,7281,Female,Penang,21,10,6,4,41,23,64,B
2015,7282,Female,Kedah,16,6,6,4,32,33,65,B
2016,7283,Female,Kedah,15,5,10,4,34,30,64,B
2017,7284,Male,Penang,15,3,5,1,24,26,50,C
2019,7285,Male,Pahang,19,6,7,2,34,39,73,B
2012,7286,Male,Selangor,21,4,6,5,36,29,65,B
2015,7287,Female,Perak,18,7,4,3,32,32,64,B
2012,7288,Male,Penang,20,10,4,2,36,34,70,B
2015,7289,Female,Selangor,14,9,6,4,33,29,62,B
2012,7290,Male,Kelantan,13,3,4,5,25,28,53,C
2018,7291,Male,Kedah,14,9,4,1,28,29,57,C
2019,7292,Female,Perak,15,8,10,3,36,23,59,C
2015,7293,Female,Selangor,15,3,7,5,30,28,58,C
2018,7294,Female,Terengganu,17,7,9,2,35,33,68,B
2017,7295,Male,Sarawak,16,9,5,2,32,23,55,C
2017,7296,Female,Sabah,13,3,9,1,26,35,61,B
2012,7297,Male,Negeri Sembilan,13,9,7,3,32,34,66,B
2019,7298,Female,Malacca,18,5,8,4,35,33,68,B
2019,7299,Female,Kelantan,13,7,9,2,31,32,63,B
2019,7300,Female,Terengganu,14,4,6,4,28,26,54,C
2012,7301,Male,Terengganu,21,10,4,3,38,37,75,B
2013,7302,Female,Pahang,20,6,7,2,35,32,67,B
2017,7303,Female,Perak,16,4,3,2,25,27,52,C
2013,7304,Female,Malacca,14,3,8,5,30,24,54,C
2017,7305,Male,Kedah,21,3,8,1,33,35,68,B
2013,7306,Male,Sarawak,17,9,7,2,35,35,70,B
2014,7307,Female,Malacca,19,6,5,5,35,33,68,B
2019,7308,Male,Selangor,13,10,5,1,29,40,69,B
2012,7309,Male,Perlis,15,6,6,5,32,28,60,B
2019,7310,Male,Kedah,19,3,6,4,32,36,68,B
2012,7311,Male,Negeri Sembilan,19,5,4,2,30,29,59,C
2019,7312,Female,Malacca,17,7,7,3,34,40,74,B
2013,7313,Male,Johor,21,3,6,3,33,31,64,B
2019,7314,Male,Perak,14,3,6,4,27,37,64,B
2013,7315,Male,Johor,13,4,8,1,26,30,56,C
2013,7316,Female,Kelantan,18,4,10,5,37,33,70,B
2014,7317,Female,Kedah,13,7,9,5,34,22,56,C
2019,7318,Female,Sabah,18,6,6,4,34,33,67,B
2017,7319,Female,Negeri Sembilan,17,7,5,5,34,23,57,C
2019,7320,Female,Selangor,21,9,3,1,34,34,68,B
2015,7321,Female,Negeri Sembilan,17,3,7,4,31,33,64,B
2018,7322,Female,Selangor,13,5,7,4,29,31,60,B
2015,7323,Male,Perlis,14,10,7,1,32,34,66,B
2017,7324,Female,Terengganu,14,4,7,4,29,26,55,C
2013,7325,Male,Perak,20,3,5,3,31,25,56,C
2015,7326,Female,Selangor,18,4,8,5,35,34,69,B
2019,7327,Male,Sarawak,21,8,10,4,43,34,77,B
2018,7328,Male,Kelantan,17,9,4,1,31,24,55,C
2014,7329,Female,Malacca,16,6,8,4,34,40,74,B
2012,7330,Male,Negeri Sembilan,19,4,4,3,30,27,57,C
2017,7331,Male,Negeri Sembilan,21,5,9,2,37,39,76,B
2014,7332,Female,Johor,21,5,6,5,37,30,67,B
2017,7333,Male,Malacca,15,3,4,4,26,29,55,C
2012,7334,Female,Pahang,13,4,8,4,29,39,68,B
2017,7335,Male,Negeri Sembilan,15,9,4,4,32,29,61,B
2014,7336,Female,Johor,14,7,4,3,28,28,56,C
2013,7337,Male,Pahang,21,7,4,2,34,27,61,B
2014,7338,Female,Johor,14,6,8,1,29,28,57,C
2016,7339,Female,Pahang,20,6,9,2,37,36,73,B
2015,7340,Female,Terengganu,17,10,4,4,35,25,60,B
2019,7341,Male,Pahang,17,9,3,1,30,29,59,C
2012,7342,Female,Malacca,19,8,6,4,37,22,59,C
2016,7343,Male,Sabah,16,6,3,1,26,38,64,B
2018,7344,Male,Sarawak,16,6,8,3,33,37,70,B
2015,7345,Female,Terengganu,17,6,3,2,28,25,53,C
2015,7346,Female,Sabah,16,10,3,2,31,24,55,C
2018,7347,Female,Perlis,14,6,4,5,29,23,52,C
2018,7348,Male,Kedah,16,8,7,1,32,27,59,C
2013,7349,Female,Sarawak,21,3,7,3,34,34,68,B
2015,7350,Female,Malacca,16,6,8,2,32,27,59,C
2017,7351,Male,Perlis,18,6,6,2,32,34,66,B
2016,7352,Female,Johor,14,3,4,1,22,39,61,B
2013,7353,Female,Penang,16,4,8,2,30,22,52,C
2016,7354,Male,Johor,20,3,10,3,36,25,61,B
2015,7355,Male,Kedah,15,3,8,3,29,35,64,B
2015,7356,Male,Perlis,19,7,8,2,36,37,73,B
2015,7357,Female,Perlis,21,8,7,4,40,35,75,B
2017,7358,Male,Perak,16,5,5,3,29,39,68,B
2015,7359,Female,Kelantan,14,10,3,4,31,36,67,B
2014,7360,Male,Pahang,20,4,8,2,34,23,57,C
2012,7361,Male,Sarawak,18,8,8,5,39,39,78,B
2015,7362,Female,Pahang,16,8,10,3,37,34,71,B
2012,7363,Female,Negeri Sembilan,13,9,3,5,30,32,62,B
2016,7364,Male,Pahang,17,9,9,2,37,32,69,B
2012,7365,Male,Terengganu,17,7,7,3,34,36,70,B
2015,7366,Male,Penang,15,6,10,5,36,36,72,B
2018,7367,Female,Pahang,19,6,6,1,32,35,67,B
2019,7368,Male,Sabah,16,9,8,4,37,33,70,B
2018,7369,Female,Perlis,21,7,5,3,36,38,74,B
2012,7370,Male,Sabah,14,8,9,2,33,25,58,C
2013,7371,Female,Kelantan,17,10,9,2,38,29,67,B
2015,7372,Female,Kelantan,14,9,8,1,32,33,65,B
2019,7373,Male,Selangor,14,9,7,5,35,38,73,B
2019,7374,Female,Sarawak,20,3,5,5,33,26,59,C
2012,7375,Male,Negeri Sembilan,15,6,6,3,30,34,64,B
2018,7376,Female,Perlis,19,6,4,2,31,31,62,B
2018,7377,Female,Pahang,18,10,4,5,37,40,77,B
2012,7378,Female,Negeri Sembilan,19,4,7,3,33,27,60,B
2019,7379,Male,Perlis,14,8,9,3,34,37,71,B
2012,7380,Male,Perlis,19,10,7,2,38,36,74,B
2014,7381,Female,Kedah,19,3,8,3,33,22,55,C
2012,7382,Female,Perlis,16,7,7,1,31,33,64,B
2016,7383,Female,Selangor,13,8,10,4,35,38,73,B
2018,7384,Female,Malacca,19,6,7,2,34,28,62,B
2016,7385,Male,Kedah,19,7,10,2,38,30,68,B
2012,7386,Female,Perak,20,10,7,2,39,32,71,B
2019,7387,Female,Negeri Sembilan,13,5,10,1,29,35,64,B
2014,7388,Male,Terengganu,15,5,7,4,31,33,64,B
2019,7389,Female,Pahang,21,7,9,4,41,29,70,B
2018,7390,Male,Pahang,13,7,9,2,31,25,56,C
2016,7391,Male,Johor,20,6,6,5,37,34,71,B
2017,7392,Male,Sabah,13,4,8,2,27,30,57,C
2019,7393,Female,Perak,20,3,5,2,30,39,69,B
2017,7394,Male,Sabah,13,9,7,5,34,28,62,B
2014,7395,Female,Negeri Sembilan,15,5,6,1,27,22,49,F
2016,7396,Female,Perak,20,4,5,4,33,34,67,B
2019,7397,Male,Perlis,20,6,5,3,34,25,59,C
2013,7398,Female,Kelantan,13,6,7,1,27,23,50,C
2019,7399,Female,Johor,15,10,5,2,32,31,63,B
2014,7400,Male,Perak,17,3,7,3,30,23,53,C
2015,7401,Female,Perlis,20,5,7,3,35,29,64,B
2018,7402,Male,Perak,18,3,10,3,34,25,59,C
2018,7403,Male,Perlis,19,8,3,1,31,40,71,B
2016,7404,Male,Johor,18,7,7,4,36,39,75,B
2013,7405,Male,Sarawak,21,9,6,5,41,24,65,B
2017,7406,Male,Kelantan,20,7,9,5,41,28,69,B
2019,7407,Male,Penang,17,9,6,2,34,36,70,B
2015,7408,Female,Negeri Sembilan,17,5,5,4,31,30,61,B
2018,7409,Male,Negeri Sembilan,15,7,8,3,33,37,70,B
2019,7410,Male,Penang,18,6,9,1,34,40,74,B
2018,7411,Male,Negeri Sembilan,20,8,9,3,40,33,73,B
2014,7412,Male,Selangor,20,6,9,5,40,28,68,B
2017,7413,Female,Kedah,20,3,5,4,32,30,62,B
2018,7414,Female,Negeri Sembilan,16,10,10,4,40,25,65,B
2016,7415,Female,Penang,19,3,6,5,33,38,71,B
2012,7416,Female,Johor,13,7,9,2,31,31,62,B
2014,7417,Male,Perak,15,5,9,2,31,25,56,C
2013,7418,Female,Pahang,18,5,4,4,31,34,65,B
2012,7419,Male,Sarawak,15,5,5,2,27,26,53,C
2013,7420,Male,Negeri Sembilan,15,4,7,1,27,32,59,C
2012,7421,Female,Sabah,20,10,8,5,43,31,74,B
2016,7422,Male,Perak,13,5,6,1,25,32,57,C
2017,7423,Male,Perlis,15,4,9,3,31,22,53,C
2012,7424,Female,Negeri Sembilan,19,10,9,3,41,39,80,A
2014,7425,Female,Johor,14,4,7,3,28,35,63,B
2014,7426,Male,Sarawak,13,9,4,2,28,30,58,C
2019,7427,Female,Penang,19,4,5,4,32,27,59,C
2018,7428,Male,Sarawak,21,9,4,1,35,34,69,B
2016,7429,Female,Selangor,14,8,4,3,29,30,59,C
2018,7430,Female,Sabah,14,3,6,1,24,35,59,C
2013,7431,Male,Perlis,16,5,3,1,25,32,57,C
2016,7432,Female,Negeri Sembilan,13,10,3,2,28,38,66,B
2014,7433,Female,Perak,19,9,7,1,36,38,74,B
2013,7434,Female,Johor,14,4,10,4,32,38,70,B
2017,7435,Male,Kelantan,16,5,6,3,30,22,52,C
2017,7436,Male,Perak,17,10,8,5,40,31,71,B
2014,7437,Male,Johor,13,4,7,1,25,29,54,C
2016,7438,Female,Perlis,20,7,6,3,36,37,73,B
2015,7439,Male,Kedah,13,9,6,4,32,25,57,C
2013,7440,Male,Perak,15,10,8,5,38,38,76,B
2018,7441,Female,Selangor,19,6,7,1,33,37,70,B
2013,7442,Female,Negeri Sembilan,14,4,6,3,27,40,67,B
2017,7443,Female,Selangor,20,8,8,4,40,23,63,B
2018,7444,Male,Kedah,14,3,5,3,25,24,49,F
2018,7445,Male,Kelantan,19,10,6,2,37,24,61,B
2018,7446,Male,Sabah,15,9,7,5,36,29,65,B
2019,7447,Female,Negeri Sembilan,20,4,8,5,37,36,73,B
2013,7448,Male,Terengganu,13,7,3,1,24,37,61,B
2015,7449,Female,Negeri Sembilan,15,5,4,1,25,36,61,B
2017,7450,Female,Kelantan,17,10,3,2,32,29,61,B
2019,7451,Male,Kelantan,20,3,7,2,32,24,56,C
2014,7452,Male,Perak,15,5,5,4,29,25,54,C
2012,7453,Male,Selangor,15,8,5,4,32,37,69,B
2015,7454,Female,Kelantan,19,8,7,3,37,38,75,B
2013,7455,Male,Kelantan,15,6,5,3,29,36,65,B
2012,7456,Male,Sarawak,15,5,8,2,30,40,70,B
2018,7457,Female,Kelantan,21,6,5,2,34,31,65,B
2019,7458,Male,Sabah,19,8,10,3,40,31,71,B
2017,7459,Female,Terengganu,15,3,9,3,30,22,52,C
2015,7460,Female,Negeri Sembilan,15,5,9,1,30,39,69,B
2019,7461,Female,Kelantan,13,10,10,1,34,39,73,B
2017,7462,Female,Penang,21,4,9,2,36,25,61,B
2012,7463,Male,Sarawak,16,7,6,2,31,30,61,B
2018,7464,Female,Selangor,18,9,4,5,36,23,59,C
2016,7465,Female,Perak,14,5,9,2,30,40,70,B
2014,7466,Female,Negeri Sembilan,21,8,9,5,43,31,74,B
2019,7467,Male,Perak,20,4,9,2,35,31,66,B
2015,7468,Female,Kelantan,13,5,6,4,28,33,61,B
2013,7469,Female,Malacca,21,6,5,3,35,24,59,C
2012,7470,Female,Terengganu,19,6,9,4,38,38,76,B
2013,7471,Male,Perlis,17,8,5,2,32,39,71,B
2015,7472,Female,Kedah,21,10,10,1,42,23,65,B
2013,7473,Female,Penang,20,5,3,2,30,28,58,C
2013,7474,Female,Sabah,17,10,5,5,37,27,64,B
2015,7475,Female,Pahang,20,6,9,2,37,32,69,B
2018,7476,Female,Malacca,16,6,8,3,33,31,64,B
2013,7477,Male,Perak,20,3,6,2,31,22,53,C
2018,7478,Female,Pahang,13,9,4,1,27,27,54,C
2017,7479,Female,Kedah,14,6,7,4,31,37,68,B
2018,7480,Female,Johor,21,6,4,2,33,24,57,C
2018,7481,Female,Johor,21,4,3,3,31,36,67,B
2015,7482,Female,Perak,20,6,4,5,35,31,66,B
2017,7483,Female,Pahang,17,8,8,3,36,32,68,B
2019,7484,Male,Penang,20,4,6,1,31,23,54,C
2015,7485,Female,Kedah,16,7,7,5,35,28,63,B
2012,7486,Male,Penang,19,8,4,3,34,29,63,B
2017,7487,Female,Kelantan,15,9,7,1,32,25,57,C
2019,7488,Female,Selangor,20,10,3,1,34,24,58,C
2017,7489,Male,Kelantan,15,10,9,2,36,29,65,B
2019,7490,Male,Johor,14,5,6,3,28,26,54,C
2013,7491,Male,Perlis,14,6,7,1,28,26,54,C
2012,7492,Female,Pahang,18,6,5,1,30,34,64,B
2018,7493,Male,Kelantan,15,8,4,4,31,38,69,B
2018,7494,Female,Perlis,14,5,8,5,32,31,63,B
2014,7495,Male,Perlis,13,6,4,3,26,27,53,C
2018,7496,Female,Sabah,13,10,4,5,32,27,59,C
2013,7497,Female,Johor,16,9,4,1,30,22,52,C
2012,7498,Female,Johor,13,8,3,5,29,28,57,C
2016,7499,Male,Selangor,21,4,6,3,34,30,64,B
2013,7500,Male,Selangor,16,10,8,3,37,35,72,B
2014,7501,Male,Pahang,19,10,7,2,38,35,73,B
2014,7502,Female,Kedah,21,8,4,3,36,25,61,B
2017,7503,Male,Perlis,19,7,10,5,41,36,77,B
2015,7504,Female,Kelantan,17,10,10,2,39,40,79,A
2014,7505,Female,Negeri Sembilan,13,4,3,1,21,22,43,F
2016,7506,Female,Penang,18,9,9,1,37,37,74,B
2016,7507,Male,Kedah,18,8,8,3,37,37,74,B
2015,7508,Female,Perlis,15,3,10,4,32,27,59,C
2014,7509,Male,Selangor,21,7,10,3,41,29,70,B
2018,7510,Female,Malacca,21,8,8,4,41,22,63,B
2018,7511,Male,Sabah,18,7,4,3,32,27,59,C
2015,7512,Male,Kedah,14,8,9,4,35,30,65,B
2016,7513,Male,Perak,18,3,8,5,34,40,74,B
2015,7514,Male,Selangor,16,3,10,4,33,36,69,B
2012,7515,Male,Negeri Sembilan,14,3,5,5,27,25,52,C
2019,7516,Male,Malacca,15,9,5,5,34,38,72,B
2018,7517,Female,Pahang,21,5,4,1,31,30,61,B
2015,7518,Male,Sabah,17,4,7,2,30,29,59,C
2013,7519,Male,Perak,13,10,8,4,35,36,71,B
2019,7520,Male,Terengganu,17,8,6,1,32,39,71,B
2017,7521,Female,Selangor,18,10,9,4,41,40,81,A
2017,7522,Female,Perak,13,4,6,1,24,38,62,B
2019,7523,Female,Johor,16,8,4,1,29,38,67,B
2019,7524,Female,Johor,15,9,9,5,38,26,64,B
2014,7525,Male,Sarawak,21,7,10,3,41,27,68,B
2018,7526,Male,Kedah,18,4,7,1,30,30,60,B
2016,7527,Male,Negeri Sembilan,15,5,9,4,33,31,64,B
2012,7528,Male,Terengganu,18,9,4,2,33,33,66,B
2013,7529,Male,Kedah,20,8,7,2,37,40,77,B
2017,7530,Male,Pahang,16,10,8,4,38,24,62,B
2013,7531,Female,Negeri Sembilan,21,3,9,1,34,39,73,B
2016,7532,Female,Kelantan,21,3,4,4,32,24,56,C
2012,7533,Female,Kedah,15,8,5,3,31,32,63,B
2014,7534,Female,Malacca,16,3,8,2,29,33,62,B
2013,7535,Female,Terengganu,15,8,8,2,33,34,67,B
2015,7536,Female,Penang,14,9,8,2,33,22,55,C
2012,7537,Male,Penang,21,7,10,4,42,37,79,A
2015,7538,Male,Malacca,19,4,5,4,32,30,62,B
2014,7539,Female,Sabah,14,10,8,1,33,25,58,C
2019,7540,Female,Penang,17,7,9,4,37,29,66,B
2015,7541,Male,Terengganu,20,9,4,2,35,32,67,B
2014,7542,Female,Kedah,18,5,10,4,37,34,71,B
2015,7543,Female,Terengganu,17,5,6,3,31,28,59,C
2015,7544,Female,Perlis,19,6,6,2,33,34,67,B
2012,7545,Female,Johor,15,7,10,2,34,31,65,B
2019,7546,Male,Johor,14,6,10,5,35,25,60,B
2015,7547,Female,Negeri Sembilan,19,5,8,4,36,31,67,B
2012,7548,Female,Negeri Sembilan,16,4,5,4,29,40,69,B
2013,7549,Male,Kelantan,16,5,5,5,31,36,67,B
2014,7550,Female,Malacca,18,8,6,3,35,40,75,B
2016,7551,Female,Malacca,18,5,8,4,35,35,70,B
2015,7552,Male,Terengganu,15,8,3,3,29,31,60,B
2014,7553,Male,Penang,21,5,7,3,36,28,64,B
2014,7554,Male,Kelantan,13,7,7,5,32,23,55,C
2012,7555,Male,Malacca,14,4,4,2,24,30,54,C
2014,7556,Male,Malacca,20,3,7,1,31,32,63,B
2012,7557,Male,Sarawak,16,10,8,2,36,24,60,B
2018,7558,Male,Selangor,21,4,10,1,36,34,70,B
2016,7559,Male,Johor,21,4,7,4,36,33,69,B
2019,7560,Female,Perak,15,3,5,2,25,29,54,C
2018,7561,Female,Kedah,19,10,4,3,36,25,61,B
2017,7562,Male,Johor,14,3,4,1,22,27,49,F
2013,7563,Female,Kedah,14,10,5,4,33,22,55,C
2018,7564,Female,Johor,19,4,5,1,29,38,67,B
2012,7565,Male,Negeri Sembilan,18,7,5,5,35,30,65,B
2017,7566,Male,Perlis,16,7,10,4,37,34,71,B
2015,7567,Female,Penang,21,7,7,4,39,35,74,B
2017,7568,Female,Johor,13,7,7,5,32,25,57,C
2016,7569,Female,Penang,21,4,4,4,33,31,64,B
2017,7570,Male,Negeri Sembilan,16,6,9,4,35,35,70,B
2017,7571,Female,Terengganu,16,7,8,2,33,30,63,B
2012,7572,Female,Sarawak,14,9,4,2,29,40,69,B
2014,7573,Male,Johor,13,5,4,1,23,32,55,C
2017,7574,Female,Sabah,19,5,9,1,34,22,56,C
2013,7575,Female,Selangor,18,10,9,2,39,23,62,B
2014,7576,Female,Kelantan,17,4,6,1,28,36,64,B
2015,7577,Female,Perak,20,6,7,1,34,28,62,B
2017,7578,Male,Kelantan,21,6,8,2,37,32,69,B
2016,7579,Female,Sabah,18,4,4,3,29,32,61,B
2018,7580,Female,Johor,21,9,7,5,42,26,68,B
2014,7581,Female,Pahang,14,4,5,1,24,23,47,F
2016,7582,Female,Malacca,16,8,5,4,33,27,60,B
2014,7583,Male,Johor,18,10,10,2,40,39,79,A
2018,7584,Female,Kedah,20,4,10,5,39,33,72,B
2019,7585,Female,Sabah,16,5,10,2,33,28,61,B
2013,7586,Female,Terengganu,18,5,4,2,29,33,62,B
2017,7587,Female,Kedah,14,10,9,2,35,32,67,B
2016,7588,Female,Sabah,21,7,3,3,34,25,59,C
2016,7589,Female,Penang,13,7,6,4,30,31,61,B
2018,7590,Male,Malacca,19,3,9,1,32,27,59,C
2018,7591,Male,Johor,16,10,3,3,32,37,69,B
2018,7592,Male,Kelantan,18,4,8,2,32,34,66,B
2017,7593,Male,Kedah,13,6,7,3,29,22,51,C
2016,7594,Female,Sarawak,18,5,5,3,31,22,53,C
2013,7595,Female,Terengganu,18,8,4,5,35,33,68,B
2019,7596,Male,Sarawak,19,4,7,4,34,26,60,B
2014,7597,Male,Selangor,17,6,8,4,35,33,68,B
2018,7598,Female,Perak,19,3,3,2,27,30,57,C
2017,7599,Male,Negeri Sembilan,14,7,10,2,33,35,68,B
2015,7600,Female,Selangor,16,3,5,1,25,35,60,B
2012,7601,Female,Kelantan,14,8,7,3,32,38,70,B
2013,7602,Male,Pahang,21,7,5,5,38,39,77,B
2016,7603,Female,Perak,14,3,3,2,22,23,45,F
2018,7604,Female,Malacca,18,5,3,5,31,24,55,C
2012,7605,Female,Negeri Sembilan,19,7,4,1,31,25,56,C
2012,7606,Female,Pahang,19,5,9,5,38,30,68,B
2018,7607,Female,Pahang,16,5,8,3,32,25,57,C
2019,7608,Male,Perlis,17,10,8,2,37,36,73,B
2015,7609,Female,Kedah,19,4,10,5,38,33,71,B
2014,7610,Female,Selangor,18,4,9,3,34,23,57,C
2014,7611,Male,Kedah,19,4,6,5,34,38,72,B
2018,7612,Female,Johor,19,10,3,1,33,25,58,C
2019,7613,Male,Kedah,19,10,8,5,42,34,76,B
2018,7614,Female,Sabah,13,4,6,2,25,24,49,F
2015,7615,Female,Penang,17,5,7,5,34,35,69,B
2019,7616,Female,Kelantan,17,4,8,3,32,31,63,B
2015,7617,Male,Sarawak,17,10,7,5,39,39,78,B
2014,7618,Female,Penang,14,4,5,3,26,26,52,C
2013,7619,Male,Selangor,17,9,4,4,34,36,70,B
2013,7620,Male,Penang,18,3,9,2,32,30,62,B
2013,7621,Male,Sarawak,19,8,4,1,32,27,59,C
2015,7622,Female,Perak,14,3,6,4,27,38,65,B
2016,7623,Female,Selangor,20,10,5,3,38,30,68,B
2018,7624,Male,Malacca,15,10,8,4,37,31,68,B
2014,7625,Female,Terengganu,16,3,4,3,26,27,53,C
2018,7626,Female,Sarawak,19,7,7,2,35,35,70,B
2017,7627,Female,Sabah,17,3,6,2,28,31,59,C
2017,7628,Female,Kelantan,19,4,8,1,32,31,63,B
2019,7629,Male,Negeri Sembilan,15,10,8,3,36,35,71,B
2013,7630,Female,Perlis,21,8,4,5,38,24,62,B
2013,7631,Male,Malacca,21,10,7,3,41,24,65,B
2018,7632,Male,Negeri Sembilan,21,6,5,3,35,31,66,B
2016,7633,Female,Negeri Sembilan,16,4,10,4,34,36,70,B
2014,7634,Male,Terengganu,13,9,7,5,34,37,71,B
2015,7635,Female,Malacca,21,3,4,4,32,39,71,B
2014,7636,Female,Terengganu,17,10,3,5,35,27,62,B
2018,7637,Male,Perak,16,3,7,5,31,25,56,C
2015,7638,Female,Malacca,15,8,9,5,37,34,71,B
2012,7639,Male,Sabah,13,8,8,5,34,36,70,B
2014,7640,Male,Kelantan,14,9,6,3,32,31,63,B
2017,7641,Female,Terengganu,20,5,5,3,33,22,55,C
2018,7642,Male,Kedah,21,4,5,3,33,33,66,B
2014,7643,Male,Penang,13,7,4,4,28,23,51,C
2019,7644,Male,Sarawak,20,9,4,2,35,34,69,B
2017,7645,Male,Pahang,21,5,3,2,31,22,53,C
2013,7646,Male,Kedah,15,9,10,4,38,26,64,B
2018,7647,Female,Johor,16,10,8,4,38,26,64,B
2013,7648,Male,Perak,14,6,3,4,27,39,66,B
2018,7649,Male,Penang,13,5,7,4,29,36,65,B
2018,7650,Male,Johor,18,3,4,3,28,37,65,B
2017,7651,Male,Malacca,18,5,5,2,30,23,53,C
2018,7652,Female,Pahang,21,5,9,5,40,33,73,B
2012,7653,Male,Pahang,21,9,3,2,35,32,67,B
2018,7654,Male,Kelantan,21,4,8,2,35,24,59,C
2013,7655,Female,Penang,18,3,10,2,33,28,61,B
2016,7656,Female,Sabah,17,3,8,1,29,35,64,B
2014,7657,Female,Sarawak,18,3,9,5,35,26,61,B
2018,7658,Female,Negeri Sembilan,19,3,8,2,32,36,68,B
2016,7659,Female,Kedah,13,5,8,4,30,29,59,C
2018,7660,Female,Negeri Sembilan,13,5,4,4,26,31,57,C
2016,7661,Female,Pahang,20,7,3,2,32,33,65,B
2015,7662,Male,Kelantan,16,8,9,4,37,36,73,B
2015,7663,Female,Pahang,21,4,3,2,30,27,57,C
2013,7664,Female,Perak,20,7,6,2,35,37,72,B
2015,7665,Male,Selangor,18,9,4,5,36,28,64,B
2012,7666,Male,Kelantan,14,9,3,5,31,31,62,B
2015,7667,Male,Perlis,21,5,7,3,36,34,70,B
2015,7668,Male,Malacca,18,6,10,1,35,22,57,C
2016,7669,Male,Terengganu,15,7,4,2,28,23,51,C
2015,7670,Female,Perlis,13,10,5,4,32,30,62,B
2013,7671,Female,Penang,16,4,7,5,32,39,71,B
2018,7672,Female,Penang,17,9,10,2,38,22,60,B
2019,7673,Male,Selangor,14,4,3,5,26,31,57,C
2012,7674,Male,Terengganu,19,10,3,1,33,28,61,B
2013,7675,Male,Perak,16,8,7,4,35,28,63,B
2017,7676,Male,Pahang,14,7,9,3,33,40,73,B
2014,7677,Male,Sabah,21,6,5,2,34,23,57,C
2013,7678,Male,Kelantan,18,6,9,3,36,26,62,B
2017,7679,Male,Sarawak,16,10,10,1,37,38,75,B
2017,7680,Female,Perlis,16,3,10,5,34,37,71,B
2016,7681,Male,Kelantan,20,8,7,3,38,35,73,B
2012,7682,Female,Selangor,19,8,6,2,35,34,69,B
2014,7683,Male,Sarawak,19,10,9,5,43,36,79,A
2013,7684,Female,Penang,17,9,5,5,36,22,58,C
2013,7685,Female,Kelantan,13,4,6,3,26,25,51,C
2016,7686,Male,Selangor,21,8,7,4,40,37,77,B
2014,7687,Male,Kelantan,21,7,4,2,34,33,67,B
2015,7688,Male,Malacca,17,10,6,3,36,32,68,B
2017,7689,Female,Kedah,18,8,4,2,32,38,70,B
2015,7690,Male,Pahang,18,6,7,2,33,32,65,B
2014,7691,Female,Malacca,13,10,10,3,36,25,61,B
2012,7692,Male,Pahang,21,10,4,1,36,36,72,B
2014,7693,Male,Sarawak,18,8,9,2,37,27,64,B
2018,7694,Male,Terengganu,20,10,8,1,39,40,79,A
2018,7695,Male,Pahang,13,10,7,5,35,32,67,B
2013,7696,Male,Kedah,19,7,5,1,32,23,55,C
2019,7697,Male,Selangor,14,4,4,2,24,34,58,C
2012,7698,Male,Perlis,14,10,8,5,37,29,66,B
2018,7699,Female,Kedah,19,8,8,2,37,30,67,B
2014,7700,Male,Pahang,21,4,8,2,35,31,66,B
2014,7701,Female,Sarawak,20,4,3,1,28,29,57,C
2017,7702,Female,Pahang,15,4,8,2,29,28,57,C
2014,7703,Female,Perlis,17,10,10,3,40,31,71,B
2013,7704,Male,Sarawak,14,9,9,4,36,23,59,C
2013,7705,Female,Selangor,18,5,6,3,32,31,63,B
2016,7706,Male,Perlis,15,3,9,4,31,33,64,B
2012,7707,Female,Kelantan,18,4,3,3,28,23,51,C
2018,7708,Male,Pahang,14,3,4,1,22,30,52,C
2013,7709,Female,Kelantan,13,7,10,2,32,26,58,C
2019,7710,Male,Penang,17,10,10,2,39,36,75,B
2012,7711,Female,Kelantan,15,6,9,1,31,22,53,C
2018,7712,Male,Perlis,14,8,4,4,30,33,63,B
2016,7713,Male,Perak,14,10,8,2,34,39,73,B
2015,7714,Female,Terengganu,13,10,10,3,36,25,61,B
2018,7715,Female,Malacca,21,5,7,5,38,36,74,B
2018,7716,Male,Malacca,20,10,10,2,42,38,80,A
2014,7717,Female,Sarawak,20,6,4,5,35,31,66,B
2012,7718,Female,Malacca,19,8,4,5,36,29,65,B
2019,7719,Male,Negeri Sembilan,16,8,10,5,39,23,62,B
2018,7720,Female,Penang,21,4,4,3,32,23,55,C
2018,7721,Male,Terengganu,18,5,10,1,34,33,67,B
2018,7722,Male,Perlis,18,9,6,2,35,22,57,C
2016,7723,Female,Perlis,16,9,6,5,36,27,63,B
2013,7724,Female,Perlis,19,4,3,2,28,25,53,C
2013,7725,Female,Kelantan,16,6,4,4,30,25,55,C
2015,7726,Male,Malacca,21,6,4,3,34,34,68,B
2016,7727,Female,Selangor,18,3,7,1,29,34,63,B
2016,7728,Male,Negeri Sembilan,17,6,7,1,31,36,67,B
2012,7729,Female,Penang,20,4,7,1,32,37,69,B
2017,7730,Female,Negeri Sembilan,15,6,8,3,32,22,54,C
2013,7731,Male,Terengganu,19,5,4,2,30,37,67,B
2018,7732,Female,Kedah,16,3,9,3,31,23,54,C
2018,7733,Male,Selangor,14,9,5,1,29,32,61,B
2013,7734,Male,Sarawak,20,6,7,5,38,37,75,B
2014,7735,Male,Sarawak,13,8,9,1,31,30,61,B
2012,7736,Female,Kelantan,16,6,9,4,35,31,66,B
2013,7737,Male,Terengganu,15,9,7,1,32,22,54,C
2012,7738,Male,Malacca,17,3,9,3,32,38,70,B
2016,7739,Male,Johor,17,7,3,4,31,25,56,C
2013,7740,Male,Perlis,13,8,10,1,32,24,56,C
2013,7741,Female,Kelantan,20,8,10,1,39,40,79,A
2012,7742,Female,Perlis,14,5,6,5,30,25,55,C
2018,7743,Female,Kedah,14,8,6,3,31,26,57,C
2013,7744,Female,Terengganu,17,7,7,5,36,29,65,B
2018,7745,Male,Kelantan,19,5,3,1,28,25,53,C
2013,7746,Female,Negeri Sembilan,20,3,9,3,35,33,68,B
2015,7747,Female,Perak,21,3,5,5,34,32,66,B
2018,7748,Female,Selangor,17,6,6,3,32,31,63,B
2018,7749,Female,Pahang,16,9,5,2,32,30,62,B
2016,7750,Male,Penang,16,8,8,5,37,29,66,B
2013,7751,Male,Kedah,18,4,5,1,28,35,63,B
2013,7752,Female,Pahang,21,3,10,2,36,35,71,B
2012,7753,Female,Sarawak,13,8,5,4,30,36,66,B
2015,7754,Female,Malacca,19,8,9,3,39,33,72,B
2016,7755,Male,Perak,18,10,7,4,39,39,78,B
2013,7756,Male,Sabah,20,9,8,1,38,27,65,B
2012,7757,Female,Perlis,13,8,8,2,31,40,71,B
2012,7758,Female,Johor,15,8,6,2,31,25,56,C
2019,7759,Female,Johor,13,9,3,2,27,40,67,B
2019,7760,Female,Perak,14,5,5,3,27,26,53,C
2017,7761,Male,Selangor,21,5,5,5,36,39,75,B
2016,7762,Male,Sabah,19,7,9,3,38,33,71,B
2019,7763,Male,Sarawak,14,3,4,1,22,36,58,C
2019,7764,Male,Sabah,15,7,8,1,31,25,56,C
2018,7765,Male,Kedah,15,5,8,5,33,33,66,B
2012,7766,Male,Pahang,16,8,8,5,37,40,77,B
2018,7767,Female,Kedah,14,4,10,3,31,34,65,B
2017,7768,Male,Negeri Sembilan,14,8,5,2,29,34,63,B
2014,7769,Male,Perlis,17,6,9,3,35,32,67,B
2017,7770,Female,Malacca,20,7,4,3,34,30,64,B
2015,7771,Female,Sabah,21,5,7,3,36,27,63,B
2019,7772,Male,Pahang,21,6,9,5,41,31,72,B
2015,7773,Female,Sabah,13,3,9,2,27,27,54,C
2012,7774,Female,Perlis,20,7,10,5,42,32,74,B
2015,7775,Male,Malacca,14,5,6,4,29,34,63,B
2017,7776,Female,Pahang,13,4,10,3,30,22,52,C
2018,7777,Male,Kedah,16,5,8,2,31,33,64,B
2012,7778,Male,Selangor,21,5,9,5,40,26,66,B
2016,7779,Female,Malacca,17,4,4,4,29,39,68,B
2019,7780,Male,Kedah,15,3,9,2,29,33,62,B
2012,7781,Male,Pahang,13,6,6,3,28,30,58,C
2018,7782,Female,Selangor,20,5,7,1,33,32,65,B
2012,7783,Female,Kelantan,19,5,7,1,32,26,58,C
2017,7784,Male,Malacca,17,5,3,4,29,22,51,C
2016,7785,Male,Sarawak,20,9,8,4,41,35,76,B
2016,7786,Male,Perlis,14,7,7,2,30,39,69,B
2012,7787,Female,Pahang,15,3,10,1,29,32,61,B
2018,7788,Female,Perlis,14,9,10,5,38,34,72,B
2014,7789,Female,Negeri Sembilan,13,5,4,4,26,34,60,B
2018,7790,Male,Selangor,15,8,3,5,31,27,58,C
2014,7791,Female,Pahang,21,6,10,1,38,37,75,B
2019,7792,Male,Selangor,15,4,3,3,25,26,51,C
2018,7793,Female,Perak,14,8,6,5,33,23,56,C
2019,7794,Male,Johor,19,3,5,2,29,29,58,C
2018,7795,Female,Pahang,21,5,5,5,36,25,61,B
2018,7796,Female,Perak,20,8,10,5,43,40,83,A
2014,7797,Male,Sabah,21,10,9,3,43,35,78,B
2016,7798,Male,Pahang,14,3,4,4,25,36,61,B
2017,7799,Male,Pahang,15,10,10,3,38,23,61,B
2015,7800,Female,Selangor,20,4,10,5,39,38,77,B
2018,7801,Female,Perak,21,4,8,3,36,32,68,B
2012,7802,Male,Kedah,21,9,7,1,38,29,67,B
2017,7803,Female,Kedah,14,6,7,1,28,22,50,C
2015,7804,Male,Penang,14,6,7,1,28,28,56,C
2015,7805,Male,Sabah,20,8,6,2,36,26,62,B
2019,7806,Male,Pahang,17,3,6,1,27,35,62,B
2017,7807,Male,Johor,13,4,8,2,27,37,64,B
2015,7808,Male,Pahang,13,7,6,5,31,36,67,B
2015,7809,Female,Kelantan,18,5,3,5,31,26,57,C
2018,7810,Female,Pahang,16,4,6,4,30,29,59,C
2019,7811,Female,Negeri Sembilan,17,4,10,3,34,25,59,C
2014,7812,Male,Pahang,16,10,6,3,35,32,67,B
2014,7813,Male,Kedah,20,7,10,4,41,29,70,B
2013,7814,Male,Selangor,21,10,9,1,41,35,76,B
2016,7815,Male,Sarawak,18,3,6,5,32,40,72,B
2019,7816,Male,Johor,15,6,6,1,28,27,55,C
2015,7817,Female,Sabah,14,8,5,2,29,33,62,B
2017,7818,Female,Negeri Sembilan,19,4,5,3,31,22,53,C
2017,7819,Male,Selangor,21,5,3,3,32,30,62,B
2013,7820,Male,Perak,16,4,9,3,32,31,63,B
2015,7821,Female,Malacca,18,10,7,1,36,32,68,B
2018,7822,Male,Kedah,18,3,9,5,35,32,67,B
2019,7823,Male,Perak,18,8,3,2,31,33,64,B
2016,7824,Female,Terengganu,21,9,9,1,40,30,70,B
2019,7825,Female,Negeri Sembilan,13,9,9,4,35,33,68,B
2016,7826,Female,Malacca,17,10,5,1,33,35,68,B
2014,7827,Female,Penang,18,8,6,3,35,26,61,B
2018,7828,Male,Perak,19,7,4,3,33,24,57,C
2016,7829,Female,Johor,21,5,7,2,35,32,67,B
2018,7830,Female,Selangor,13,5,4,5,27,33,60,B
2017,7831,Female,Johor,14,10,9,1,34,29,63,B
2012,7832,Female,Negeri Sembilan,16,6,6,1,29,38,67,B
2019,7833,Male,Malacca,15,10,6,4,35,35,70,B
2017,7834,Female,Terengganu,19,8,3,4,34,34,68,B
2012,7835,Female,Perlis,18,3,3,1,25,32,57,C
2013,7836,Male,Sabah,20,9,5,4,38,33,71,B
2019,7837,Male,Penang,20,6,4,3,33,23,56,C
2017,7838,Female,Pahang,16,8,6,5,35,37,72,B
2014,7839,Male,Negeri Sembilan,17,10,9,5,41,33,74,B
2017,7840,Female,Pahang,21,5,10,1,37,33,70,B
2013,7841,Male,Pahang,18,8,3,3,32,40,72,B
2019,7842,Female,Terengganu,20,9,7,5,41,33,74,B
2013,7843,Female,Perak,13,10,8,1,32,35,67,B
2013,7844,Male,Kedah,15,8,6,4,33,31,64,B
2019,7845,Female,Terengganu,20,8,9,4,41,24,65,B
2012,7846,Female,Sabah,14,10,7,4,35,37,72,B
2016,7847,Male,Perak,20,8,3,3,34,39,73,B
2014,7848,Female,Penang,21,8,3,3,35,37,72,B
2018,7849,Female,Perlis,14,8,8,4,34,24,58,C
2015,7850,Female,Pahang,21,3,9,1,34,24,58,C
2018,7851,Female,Sabah,15,8,6,2,31,24,55,C
2013,7852,Male,Pahang,15,8,7,5,35,34,69,B
2012,7853,Female,Negeri Sembilan,15,6,7,3,31,25,56,C
2016,7854,Female,Kedah,19,9,7,1,36,32,68,B
2017,7855,Female,Johor,15,9,8,2,34,28,62,B
2018,7856,Male,Sabah,17,7,9,1,34,26,60,B
2014,7857,Male,Malacca,15,5,6,1,27,28,55,C
2014,7858,Male,Johor,21,6,4,4,35,39,74,B
2014,7859,Female,Kedah,19,7,6,2,34,24,58,C
2019,7860,Female,Sarawak,20,8,9,4,41,23,64,B
2012,7861,Female,Selangor,19,6,9,3,37,40,77,B
2019,7862,Female,Malacca,21,5,5,2,33,26,59,C
2015,7863,Male,Perak,19,7,9,1,36,39,75,B
2013,7864,Male,Johor,19,6,10,5,40,32,72,B
2014,7865,Female,Sabah,20,9,10,4,43,36,79,A
2016,7866,Female,Kelantan,16,6,4,3,29,40,69,B
2016,7867,Female,Selangor,14,8,5,2,29,29,58,C
2015,7868,Male,Perlis,18,5,9,2,34,28,62,B
2015,7869,Female,Perak,20,9,10,1,40,25,65,B
2019,7870,Female,Kelantan,17,6,4,4,31,25,56,C
2018,7871,Male,Terengganu,15,4,8,5,32,32,64,B
2019,7872,Male,Sabah,19,9,5,5,38,36,74,B
2012,7873,Female,Kedah,19,9,5,5,38,35,73,B
2018,7874,Female,Selangor,14,9,6,2,31,24,55,C
2016,7875,Female,Negeri Sembilan,13,9,9,2,33,25,58,C
2019,7876,Female,Perak,13,3,4,4,24,32,56,C
2012,7877,Female,Perak,18,9,3,4,34,38,72,B
2016,7878,Male,Selangor,14,8,9,4,35,22,57,C
2014,7879,Male,Selangor,15,10,5,3,33,27,60,B
2018,7880,Female,Negeri Sembilan,19,4,8,5,36,26,62,B
2017,7881,Male,Terengganu,19,9,10,3,41,23,64,B
2014,7882,Female,Johor,18,6,3,5,32,32,64,B
2012,7883,Male,Perlis,13,10,3,5,31,37,68,B
2015,7884,Female,Negeri Sembilan,19,5,8,2,34,37,71,B
2013,7885,Female,Perak,19,3,8,2,32,30,62,B
2017,7886,Female,Terengganu,21,4,7,4,36,24,60,B
2012,7887,Male,Negeri Sembilan,17,3,5,1,26,39,65,B
2014,7888,Female,Perlis,17,6,4,1,28,26,54,C
2016,7889,Female,Malacca,20,3,5,3,31,32,63,B
2017,7890,Female,Kedah,19,7,9,2,37,39,76,B
2012,7891,Female,Kelantan,15,8,7,5,35,26,61,B
2017,7892,Female,Sabah,19,5,4,2,30,31,61,B
2017,7893,Male,Perak,15,4,3,5,27,40,67,B
2013,7894,Female,Perlis,18,10,9,2,39,35,74,B
2015,7895,Female,Pahang,16,7,8,5,36,39,75,B
2019,7896,Male,Perak,19,5,8,5,37,34,71,B
2015,7897,Female,Terengganu,19,9,6,2,36,39,75,B
2014,7898,Male,Selangor,14,5,6,3,28,35,63,B
2017,7899,Female,Terengganu,20,9,7,2,38,35,73,B
2012,7900,Male,Perak,17,3,8,3,31,40,71,B
2019,7901,Male,Negeri Sembilan,15,10,9,4,38,30,68,B
2015,7902,Male,Kedah,17,3,8,3,31,38,69,B
2017,7903,Male,Pahang,19,8,7,4,38,39,77,B
2017,7904,Male,Kedah,15,5,9,2,31,33,64,B
2012,7905,Female,Terengganu,16,9,7,1,33,34,67,B
2014,7906,Female,Selangor,19,7,5,4,35,36,71,B
2012,7907,Male,Sarawak,15,4,7,3,29,26,55,C
2013,7908,Female,Malacca,19,8,10,1,38,28,66,B
2014,7909,Male,Malacca,21,7,8,3,39,27,66,B
2013,7910,Female,Selangor,14,6,3,1,24,32,56,C
2013,7911,Male,Malacca,13,9,7,4,33,22,55,C
2018,7912,Male,Kedah,20,6,7,2,35,37,72,B
2013,7913,Female,Perlis,13,10,3,5,31,26,57,C
2015,7914,Female,Perlis,14,9,9,3,35,30,65,B
2019,7915,Female,Kelantan,14,8,5,4,31,28,59,C
2018,7916,Male,Johor,16,6,4,1,27,30,57,C
2017,7917,Female,Kelantan,16,10,4,3,33,29,62,B
2018,7918,Female,Perak,13,4,3,2,22,30,52,C
2014,7919,Female,Johor,15,9,9,5,38,40,78,B
2012,7920,Female,Kedah,20,8,6,5,39,35,74,B
2014,7921,Female,Terengganu,13,9,5,3,30,36,66,B
2016,7922,Male,Selangor,17,8,4,1,30,34,64,B
2019,7923,Female,Johor,19,6,9,3,37,32,69,B
2012,7924,Female,Terengganu,21,10,9,1,41,30,71,B
2012,7925,Male,Perlis,13,6,9,5,33,38,71,B
2012,7926,Female,Perlis,21,5,4,2,32,38,70,B
2019,7927,Female,Negeri Sembilan,21,4,4,1,30,31,61,B
2018,7928,Female,Sabah,21,3,8,3,35,23,58,C
2013,7929,Male,Negeri Sembilan,19,5,3,3,30,24,54,C
2018,7930,Male,Perlis,19,9,9,4,41,35,76,B
2016,7931,Male,Penang,19,3,10,2,34,40,74,B
2012,7932,Female,Malacca,15,8,8,1,32,25,57,C
2012,7933,Male,Kelantan,21,4,8,3,36,38,74,B
2013,7934,Male,Kedah,14,9,6,5,34,34,68,B
2015,7935,Male,Kedah,19,9,10,5,43,32,75,B
2018,7936,Male,Perlis,19,8,6,4,37,40,77,B
2015,7937,Male,Penang,18,4,9,5,36,22,58,C
2012,7938,Female,Sarawak,20,5,5,2,32,33,65,B
2019,7939,Male,Kelantan,14,5,10,2,31,33,64,B
2014,7940,Female,Sabah,15,4,5,2,26,30,56,C
2015,7941,Male,Perlis,18,8,3,5,34,29,63,B
2017,7942,Female,Penang,20,4,3,5,32,32,64,B
2012,7943,Male,Kelantan,17,5,7,2,31,29,60,B
2014,7944,Female,Sabah,21,4,5,4,34,28,62,B
2013,7945,Male,Negeri Sembilan,13,10,6,5,34,36,70,B
2017,7946,Male,Selangor,16,5,9,3,33,27,60,B
2019,7947,Male,Selangor,15,7,7,2,31,23,54,C
2019,7948,Male,Sarawak,17,7,3,3,30,34,64,B
2013,7949,Male,Johor,18,3,9,4,34,25,59,C
2018,7950,Female,Terengganu,18,7,6,2,33,32,65,B
2013,7951,Female,Sabah,13,4,8,1,26,33,59,C
2017,7952,Female,Perlis,13,9,7,1,30,23,53,C
2012,7953,Male,Penang,21,3,5,4,33,24,57,C
2012,7954,Male,Selangor,21,9,10,5,45,26,71,B
2019,7955,Male,Malacca,15,3,10,5,33,38,71,B
2012,7956,Male,Terengganu,19,4,7,4,34,25,59,C
2013,7957,Female,Perlis,17,3,4,4,28,26,54,C
2017,7958,Male,Malacca,13,7,5,2,27,34,61,B
2012,7959,Male,Penang,16,10,3,5,34,32,66,B
2018,7960,Female,Negeri Sembilan,20,8,7,1,36,29,65,B
2018,7961,Male,Pahang,19,9,6,2,36,23,59,C
2019,7962,Female,Malacca,16,9,9,5,39,27,66,B
2012,7963,Female,Penang,14,4,4,4,26,32,58,C
2018,7964,Male,Kedah,16,3,7,4,30,37,67,B
2016,7965,Female,Pahang,20,9,8,5,42,27,69,B
2018,7966,Female,Terengganu,17,6,3,5,31,34,65,B
2018,7967,Female,Perak,20,10,10,1,41,30,71,B
2015,7968,Female,Sabah,17,9,10,1,37,31,68,B
2016,7969,Male,Negeri Sembilan,21,8,10,3,42,40,82,A
2019,7970,Female,Negeri Sembilan,14,9,5,4,32,32,64,B
2012,7971,Male,Johor,18,5,7,1,31,34,65,B
2019,7972,Male,Malacca,20,9,3,3,35,39,74,B
2012,7973,Male,Perak,13,4,5,3,25,24,49,F
2018,7974,Male,Pahang,18,6,10,2,36,38,74,B
2015,7975,Male,Kedah,18,4,3,1,26,34,60,B
2015,7976,Female,Johor,21,7,5,2,35,36,71,B
2015,7977,Female,Penang,16,8,6,4,34,31,65,B
2019,7978,Female,Perlis,13,4,4,4,25,37,62,B
2018,7979,Female,Malacca,16,9,7,1,33,34,67,B
2015,7980,Female,Sabah,15,6,8,2,31,22,53,C
2017,7981,Female,Kelantan,20,9,5,4,38,22,60,B
2014,7982,Female,Perlis,16,5,8,1,30,38,68,B
2016,7983,Female,Selangor,20,9,8,5,42,31,73,B
2016,7984,Female,Malacca,13,8,6,1,28,25,53,C
2012,7985,Male,Sabah,18,8,8,5,39,35,74,B
2017,7986,Female,Perlis,20,8,7,4,39,27,66,B
2015,7987,Male,Penang,19,7,10,2,38,38,76,B
2016,7988,Male,Sarawak,19,5,6,2,32,24,56,C
2014,7989,Female,Sarawak,20,10,10,3,43,27,70,B
2019,7990,Female,Penang,18,8,7,1,34,29,63,B
2012,7991,Female,Selangor,14,10,9,1,34,26,60,B
2013,7992,Male,Malacca,13,10,9,2,34,36,70,B
2014,7993,Female,Terengganu,15,7,7,2,31,22,53,C
2019,7994,Male,Terengganu,16,8,8,5,37,39,76,B
2016,7995,Female,Pahang,17,9,5,5,36,40,76,B
2019,7996,Female,Sabah,13,6,3,2,24,24,48,F
2016,7997,Female,Sabah,18,4,6,5,33,26,59,C
2014,7998,Male,Sabah,21,4,7,1,33,28,61,B
2012,7999,Female,Malacca,13,10,3,2,28,34,62,B
2018,8000,Female,Sabah,13,10,9,3,35,36,71,B
2013,8001,Female,Penang,16,4,6,5,31,31,62,B
2017,8002,Female,Perlis,18,5,9,5,37,30,67,B
2016,8003,Male,Terengganu,15,9,3,1,28,28,56,C
2013,8004,Female,Sabah,14,8,6,3,31,28,59,C
2017,8005,Female,Malacca,15,6,4,1,26,31,57,C
2013,8006,Male,Perak,15,4,3,4,26,23,49,F
2012,8007,Female,Selangor,17,9,3,4,33,40,73,B
2017,8008,Male,Kedah,16,4,7,3,30,26,56,C
2013,8009,Female,Johor,15,8,3,3,29,36,65,B
2019,8010,Female,Negeri Sembilan,18,7,9,3,37,35,72,B
2014,8011,Female,Negeri Sembilan,16,9,6,3,34,23,57,C
2016,8012,Male,Sarawak,18,4,8,2,32,24,56,C
2013,8013,Female,Terengganu,16,7,10,3,36,23,59,C
2017,8014,Male,Johor,13,3,10,4,30,31,61,B
2015,8015,Female,Sarawak,14,3,5,1,23,28,51,C
2012,8016,Female,Sabah,14,3,4,1,22,40,62,B
2014,8017,Male,Negeri Sembilan,18,9,10,5,42,25,67,B
2017,8018,Male,Sabah,14,4,8,3,29,33,62,B
2016,8019,Male,Sabah,13,10,9,1,33,27,60,B
2018,8020,Female,Sabah,18,5,7,1,31,22,53,C
2014,8021,Male,Negeri Sembilan,18,8,3,2,31,25,56,C
2015,8022,Male,Kelantan,15,3,9,2,29,33,62,B
2019,8023,Female,Pahang,17,7,6,4,34,29,63,B
2016,8024,Male,Pahang,16,5,7,1,29,29,58,C
2014,8025,Female,Perak,16,10,9,3,38,30,68,B
2013,8026,Male,Perak,21,6,6,3,36,39,75,B
2014,8027,Male,Selangor,21,5,9,4,39,25,64,B
2012,8028,Male,Terengganu,16,6,9,4,35,29,64,B
2013,8029,Female,Negeri Sembilan,19,3,7,5,34,39,73,B
2017,8030,Female,Perak,18,9,5,1,33,22,55,C
2017,8031,Male,Perlis,16,9,5,1,31,22,53,C
2019,8032,Male,Penang,21,6,3,3,33,38,71,B
2013,8033,Female,Perlis,21,7,6,1,35,33,68,B
2014,8034,Female,Kedah,19,10,8,2,39,29,68,B
2019,8035,Male,Johor,15,9,10,1,35,27,62,B
2018,8036,Female,Sarawak,14,10,9,2,35,26,61,B
2014,8037,Male,Selangor,20,10,10,1,41,29,70,B
2019,8038,Male,Perlis,18,3,10,3,34,25,59,C
2019,8039,Female,Kelantan,13,6,10,3,32,32,64,B
2013,8040,Female,Terengganu,14,8,5,3,30,26,56,C
2017,8041,Female,Sabah,20,3,9,2,34,22,56,C
2016,8042,Male,Malacca,17,4,6,3,30,37,67,B
2015,8043,Female,Kedah,18,5,8,2,33,29,62,B
2013,8044,Male,Malacca,20,6,7,5,38,40,78,B
2015,8045,Male,Penang,20,10,5,1,36,35,71,B
2016,8046,Male,Kedah,19,3,10,2,34,37,71,B
2014,8047,Female,Perlis,20,8,9,5,42,25,67,B
2016,8048,Female,Malacca,13,7,9,3,32,35,67,B
2017,8049,Female,Kelantan,13,3,5,2,23,22,45,F
2014,8050,Female,Perlis,20,10,10,4,44,37,81,A
2018,8051,Female,Kedah,18,7,7,3,35,25,60,B
2016,8052,Female,Sarawak,13,10,3,1,27,35,62,B
2016,8053,Female,Malacca,14,10,5,3,32,22,54,C
2014,8054,Female,Sabah,14,10,8,3,35,37,72,B
2016,8055,Male,Negeri Sembilan,16,4,8,4,32,40,72,B
2016,8056,Female,Perak,17,10,7,1,35,30,65,B
2017,8057,Male,Perlis,19,4,4,4,31,27,58,C
2016,8058,Male,Perak,13,3,5,4,25,24,49,F
2014,8059,Male,Terengganu,14,8,5,3,30,31,61,B
2018,8060,Male,Perak,15,3,9,5,32,39,71,B
2016,8061,Female,Selangor,16,8,9,4,37,31,68,B
2014,8062,Female,Terengganu,17,10,5,4,36,25,61,B
2013,8063,Male,Johor,13,3,4,2,22,40,62,B
2015,8064,Male,Johor,17,9,6,3,35,32,67,B
2019,8065,Female,Selangor,14,10,7,5,36,39,75,B
2012,8066,Male,Malacca,15,9,5,5,34,36,70,B
2015,8067,Male,Terengganu,14,4,3,2,23,26,49,F
2012,8068,Female,Malacca,15,5,6,1,27,28,55,C
2018,8069,Female,Pahang,14,6,5,3,28,38,66,B
2015,8070,Male,Johor,14,9,9,5,37,35,72,B
2012,8071,Male,Sabah,14,4,6,1,25,40,65,B
2018,8072,Female,Selangor,15,10,7,1,33,28,61,B
2014,8073,Female,Perlis,17,7,4,4,32,31,63,B
2015,8074,Female,Kedah,13,8,10,1,32,37,69,B
2013,8075,Female,Terengganu,17,9,6,5,37,35,72,B
2016,8076,Female,Perak,20,8,6,5,39,29,68,B
2015,8077,Female,Perlis,21,6,9,4,40,22,62,B
2013,8078,Female,Perak,17,3,3,4,27,40,67,B
2013,8079,Female,Perak,20,6,3,3,32,29,61,B
2016,8080,Female,Kedah,21,10,5,4,40,29,69,B
2019,8081,Male,Penang,18,9,6,4,37,39,76,B
2016,8082,Female,Negeri Sembilan,20,4,8,3,35,29,64,B
2018,8083,Female,Perlis,14,5,3,1,23,29,52,C
2016,8084,Female,Pahang,15,8,9,2,34,34,68,B
2017,8085,Female,Kedah,17,4,3,1,25,25,50,C
2017,8086,Male,Perak,13,4,10,2,29,37,66,B
2018,8087,Male,Kelantan,19,8,4,2,33,32,65,B
2014,8088,Female,Malacca,14,5,8,4,31,29,60,B
2018,8089,Male,Malacca,14,7,10,5,36,27,63,B
2018,8090,Male,Malacca,19,6,7,4,36,36,72,B
2013,8091,Female,Selangor,13,5,5,4,27,40,67,B
2016,8092,Female,Johor,14,5,9,3,31,31,62,B
2015,8093,Male,Terengganu,14,8,5,1,28,35,63,B
2012,8094,Female,Malacca,18,10,3,5,36,28,64,B
2013,8095,Male,Malacca,16,4,3,3,26,40,66,B
2013,8096,Female,Perlis,13,5,4,1,23,30,53,C
2015,8097,Male,Malacca,21,5,3,4,33,23,56,C
2018,8098,Male,Kelantan,14,7,10,2,33,34,67,B
2014,8099,Female,Kelantan,19,8,5,1,33,30,63,B
2013,8100,Male,Sabah,21,4,10,1,36,23,59,C
2016,8101,Male,Johor,20,8,6,3,37,33,70,B
2016,8102,Male,Kedah,20,5,8,5,38,30,68,B
2013,8103,Female,Johor,14,6,3,3,26,40,66,B
2014,8104,Female,Penang,20,6,10,4,40,32,72,B
2019,8105,Male,Johor,21,10,9,3,43,39,82,A
2013,8106,Female,Selangor,16,5,7,2,30,28,58,C
2015,8107,Male,Johor,16,9,8,4,37,40,77,B
2018,8108,Female,Sabah,19,8,5,2,34,39,73,B
2018,8109,Female,Selangor,16,10,8,2,36,24,60,B
2012,8110,Female,Sabah,19,7,5,1,32,29,61,B
2019,8111,Female,Perlis,15,5,8,2,30,38,68,B
2016,8112,Male,Selangor,14,7,4,4,29,37,66,B
2016,8113,Female,Selangor,19,3,7,3,32,31,63,B
2018,8114,Male,Perlis,17,7,9,5,38,29,67,B
2017,8115,Male,Terengganu,15,5,4,3,27,27,54,C
2019,8116,Male,Penang,20,5,3,2,30,39,69,B
2018,8117,Female,Kelantan,16,9,3,2,30,29,59,C
2017,8118,Male,Terengganu,18,9,5,4,36,31,67,B
2019,8119,Female,Kedah,15,10,4,4,33,25,58,C
2018,8120,Male,Kedah,14,5,8,1,28,27,55,C
2018,8121,Female,Sabah,19,5,6,4,34,26,60,B
2016,8122,Male,Terengganu,21,8,3,4,36,22,58,C
2017,8123,Female,Malacca,20,9,3,2,34,23,57,C
2015,8124,Female,Sabah,17,6,8,1,32,36,68,B
2017,8125,Female,Perak,18,6,3,4,31,35,66,B
2018,8126,Female,Malacca,19,5,8,2,34,22,56,C
2019,8127,Male,Sarawak,15,10,3,2,30,25,55,C
2015,8128,Female,Malacca,19,7,10,2,38,30,68,B
2014,8129,Male,Perak,18,9,5,1,33,40,73,B
2019,8130,Male,Perak,17,9,3,4,33,23,56,C
2013,8131,Male,Sabah,16,4,6,3,29,39,68,B
2012,8132,Male,Selangor,13,6,7,1,27,37,64,B
2013,8133,Male,Negeri Sembilan,16,6,8,1,31,29,60,B
2014,8134,Male,Negeri Sembilan,19,9,3,4,35,26,61,B
2014,8135,Male,Kelantan,20,6,7,4,37,32,69,B
2013,8136,Male,Sabah,18,5,5,1,29,28,57,C
2018,8137,Male,Negeri Sembilan,13,3,5,2,23,34,57,C
2013,8138,Female,Sarawak,21,3,6,5,35,34,69,B
2013,8139,Female,Sarawak,17,5,8,5,35,30,65,B
2014,8140,Male,Sabah,13,5,5,3,26,26,52,C
2012,8141,Male,Johor,14,10,8,1,33,32,65,B
2016,8142,Female,Malacca,21,6,8,5,40,32,72,B
2014,8143,Female,Kelantan,15,10,6,5,36,37,73,B
2015,8144,Male,Terengganu,17,6,9,1,33,37,70,B
2014,8145,Male,Sabah,17,8,5,1,31,36,67,B
2014,8146,Male,Malacca,20,5,9,2,36,37,73,B
2015,8147,Male,Terengganu,21,5,3,5,34,39,73,B
2016,8148,Female,Selangor,16,4,4,1,25,34,59,C
2016,8149,Male,Negeri Sembilan,19,5,3,5,32,39,71,B
2014,8150,Female,Perlis,20,5,7,1,33,33,66,B
2019,8151,Male,Kedah,14,9,10,4,37,33,70,B
2013,8152,Male,Negeri Sembilan,18,9,3,3,33,40,73,B
2019,8153,Male,Johor,18,4,9,4,35,38,73,B
2013,8154,Male,Selangor,21,10,10,4,45,36,81,A
2014,8155,Male,Perlis,16,8,8,1,33,23,56,C
2012,8156,Female,Pahang,13,4,7,4,28,36,64,B
2013,8157,Male,Terengganu,17,10,3,3,33,29,62,B
2018,8158,Female,Negeri Sembilan,20,4,6,1,31,29,60,B
2019,8159,Female,Selangor,20,3,5,2,30,40,70,B
2014,8160,Female,Penang,20,4,5,2,31,34,65,B
2018,8161,Female,Malacca,17,10,4,2,33,22,55,C
2018,8162,Male,Sarawak,15,3,6,5,29,26,55,C
2016,8163,Male,Terengganu,20,3,3,2,28,33,61,B
2015,8164,Female,Sarawak,19,6,10,2,37,30,67,B
2015,8165,Female,Terengganu,20,5,4,5,34,40,74,B
2014,8166,Male,Kedah,21,10,3,5,39,32,71,B
2012,8167,Male,Penang,21,8,4,1,34,37,71,B
2012,8168,Male,Sabah,15,3,8,4,30,28,58,C
2013,8169,Male,Kelantan,15,7,4,4,30,30,60,B
2015,8170,Male,Selangor,21,7,6,2,36,30,66,B
2017,8171,Female,Malacca,19,5,4,4,32,26,58,C
2018,8172,Female,Terengganu,19,3,10,2,34,40,74,B
2015,8173,Male,Penang,16,9,6,2,33,29,62,B
2018,8174,Female,Perlis,20,3,6,1,30,30,60,B
2012,8175,Female,Sabah,18,5,5,3,31,27,58,C
2017,8176,Male,Penang,20,9,5,1,35,39,74,B
2018,8177,Female,Negeri Sembilan,13,7,9,1,30,23,53,C
2018,8178,Female,Perlis,16,9,6,5,36,22,58,C
2012,8179,Female,Johor,19,4,5,4,32,35,67,B
2013,8180,Male,Johor,13,8,7,1,29,26,55,C
2012,8181,Male,Selangor,14,10,6,4,34,31,65,B
2019,8182,Male,Perlis,20,10,10,4,44,37,81,A
2013,8183,Male,Perlis,17,9,7,4,37,36,73,B
2018,8184,Female,Terengganu,19,5,9,4,37,29,66,B
2019,8185,Female,Kedah,15,7,8,2,32,38,70,B
2018,8186,Male,Perlis,20,9,9,3,41,26,67,B
2014,8187,Male,Selangor,14,7,7,1,29,26,55,C
2015,8188,Female,Selangor,19,4,7,1,31,34,65,B
2016,8189,Female,Perak,14,3,8,3,28,27,55,C
2014,8190,Male,Negeri Sembilan,17,4,5,2,28,26,54,C
2014,8191,Female,Johor,13,7,8,5,33,39,72,B
2018,8192,Male,Perak,20,3,10,2,35,38,73,B
2016,8193,Female,Penang,19,10,5,5,39,38,77,B
2018,8194,Male,Negeri Sembilan,18,10,8,2,38,38,76,B
2017,8195,Female,Sarawak,14,4,8,5,31,36,67,B
2019,8196,Female,Kelantan,15,10,10,2,37,26,63,B
2014,8197,Male,Selangor,16,10,6,4,36,25,61,B
2017,8198,Female,Kelantan,18,5,10,4,37,27,64,B
2015,8199,Male,Penang,18,9,9,4,40,38,78,B
2019,8200,Female,Kelantan,21,4,5,2,32,28,60,B
2014,8201,Female,Sarawak,20,7,5,2,34,37,71,B
2015,8202,Female,Terengganu,19,10,9,1,39,32,71,B
2015,8203,Male,Perak,21,9,10,1,41,25,66,B
2013,8204,Female,Pahang,16,3,8,5,32,29,61,B
2012,8205,Female,Penang,15,6,3,2,26,34,60,B
2017,8206,Male,Johor,21,7,7,5,40,24,64,B
2017,8207,Male,Selangor,19,9,7,5,40,24,64,B
2014,8208,Female,Sabah,17,7,8,5,37,23,60,B
2018,8209,Male,Malacca,17,7,9,1,34,25,59,C
2019,8210,Male,Perlis,15,3,9,5,32,34,66,B
2014,8211,Female,Negeri Sembilan,16,5,8,2,31,32,63,B
2015,8212,Female,Pahang,14,3,10,3,30,25,55,C
2013,8213,Male,Pahang,20,3,3,3,29,28,57,C
2012,8214,Male,Sarawak,18,3,5,5,31,28,59,C
2019,8215,Female,Kedah,17,3,3,2,25,25,50,C
2018,8216,Female,Malacca,15,3,5,3,26,27,53,C
2015,8217,Male,Penang,14,9,10,5,38,35,73,B
2013,8218,Female,Terengganu,15,6,7,3,31,34,65,B
2013,8219,Male,Kedah,20,5,10,1,36,31,67,B
2013,8220,Male,Sabah,21,7,9,3,40,26,66,B
2015,8221,Male,Kedah,17,10,3,5,35,39,74,B
2012,8222,Male,Sarawak,19,9,6,5,39,33,72,B
2015,8223,Female,Pahang,15,9,6,4,34,23,57,C
2019,8224,Male,Kelantan,16,3,9,3,31,27,58,C
2016,8225,Male,Penang,21,4,10,3,38,27,65,B
2013,8226,Male,Sarawak,18,10,5,5,38,25,63,B
2017,8227,Male,Sarawak,20,10,3,3,36,28,64,B
2015,8228,Male,Sabah,20,8,3,4,35,36,71,B
2019,8229,Female,Perak,17,3,10,1,31,30,61,B
2017,8230,Female,Kedah,13,8,7,4,32,29,61,B
2018,8231,Female,Kelantan,21,5,6,5,37,32,69,B
2018,8232,Female,Sarawak,15,3,9,2,29,23,52,C
2017,8233,Male,Sarawak,15,4,9,4,32,35,67,B
2018,8234,Female,Sabah,21,9,3,2,35,30,65,B
2013,8235,Male,Terengganu,16,7,6,2,31,23,54,C
2019,8236,Male,Perak,13,4,7,3,27,39,66,B
2016,8237,Female,Sabah,13,7,10,4,34,32,66,B
2016,8238,Male,Perak,21,10,4,5,40,31,71,B
2013,8239,Male,Selangor,18,7,6,5,36,33,69,B
2012,8240,Female,Selangor,20,7,5,3,35,26,61,B
2013,8241,Male,Terengganu,17,9,5,5,36,28,64,B
2013,8242,Female,Negeri Sembilan,15,5,3,3,26,37,63,B
2013,8243,Female,Terengganu,13,6,9,4,32,26,58,C
2016,8244,Female,Malacca,16,6,8,5,35,30,65,B
2018,8245,Male,Negeri Sembilan,21,3,10,5,39,28,67,B
2019,8246,Male,Johor,20,3,4,3,30,26,56,C
2012,8247,Female,Malacca,18,9,8,5,40,31,71,B
2015,8248,Female,Sarawak,16,3,5,2,26,24,50,C
2012,8249,Male,Kelantan,17,5,4,3,29,31,60,B
2015,8250,Female,Perak,15,7,3,3,28,31,59,C
2013,8251,Female,Negeri Sembilan,19,8,10,5,42,34,76,B
2012,8252,Male,Malacca,15,9,8,1,33,39,72,B
2013,8253,Female,Perak,20,6,9,2,37,40,77,B
2015,8254,Female,Sarawak,21,9,3,4,37,33,70,B
2012,8255,Male,Kedah,13,4,8,1,26,26,52,C
2015,8256,Male,Johor,14,6,7,1,28,31,59,C
2018,8257,Male,Sabah,14,10,8,5,37,37,74,B
2018,8258,Male,Malacca,19,5,7,1,32,39,71,B
2018,8259,Female,Penang,19,5,6,3,33,38,71,B
2013,8260,Female,Penang,20,8,7,2,37,38,75,B
2016,8261,Female,Kedah,15,8,5,4,32,29,61,B
2016,8262,Female,Perlis,17,8,7,4,36,38,74,B
2014,8263,Female,Kedah,14,6,6,3,29,26,55,C
2012,8264,Male,Penang,18,10,6,3,37,39,76,B
2012,8265,Female,Terengganu,19,4,10,4,37,33,70,B
2016,8266,Male,Kedah,17,4,4,3,28,28,56,C
2014,8267,Female,Kelantan,13,4,7,3,27,38,65,B
2019,8268,Male,Sabah,15,8,4,4,31,32,63,B
2016,8269,Male,Johor,14,6,5,4,29,31,60,B
2012,8270,Male,Terengganu,15,4,10,4,33,34,67,B
2012,8271,Male,Malacca,19,10,8,5,42,24,66,B
2013,8272,Female,Terengganu,13,8,6,4,31,26,57,C
2012,8273,Male,Sarawak,15,8,4,1,28,30,58,C
2019,8274,Female,Sarawak,13,10,8,5,36,24,60,B
2018,8275,Female,Kelantan,14,8,6,5,33,40,73,B
2014,8276,Male,Pahang,18,5,8,2,33,26,59,C
2018,8277,Male,Kedah,13,3,9,3,28,38,66,B
2019,8278,Female,Terengganu,16,9,3,2,30,35,65,B
2015,8279,Male,Selangor,16,5,9,1,31,29,60,B
2017,8280,Male,Pahang,14,6,8,1,29,23,52,C
2014,8281,Male,Sarawak,16,7,8,4,35,40,75,B
2018,8282,Male,Selangor,13,9,3,4,29,35,64,B
2016,8283,Male,Kelantan,13,8,3,4,28,26,54,C
2019,8284,Female,Sarawak,15,8,6,5,34,40,74,B
2014,8285,Male,Perlis,20,8,9,4,41,29,70,B
2018,8286,Female,Perlis,20,10,3,5,38,25,63,B
2018,8287,Female,Malacca,19,10,9,5,43,38,81,A
2012,8288,Female,Perlis,16,4,3,2,25,38,63,B
2018,8289,Female,Negeri Sembilan,17,7,6,3,33,32,65,B
2015,8290,Male,Sarawak,15,9,7,3,34,35,69,B
2016,8291,Male,Penang,14,4,5,3,26,38,64,B
2015,8292,Female,Kedah,16,3,8,5,32,35,67,B
2015,8293,Female,Negeri Sembilan,21,7,3,5,36,28,64,B
2014,8294,Male,Sabah,17,5,7,5,34,26,60,B
2019,8295,Male,Sarawak,20,9,4,1,34,24,58,C
2016,8296,Male,Sarawak,21,8,6,5,40,22,62,B
2013,8297,Male,Pahang,21,3,6,5,35,22,57,C
2015,8298,Female,Negeri Sembilan,15,6,9,5,35,25,60,B
2019,8299,Male,Terengganu,20,7,6,4,37,33,70,B
2013,8300,Female,Negeri Sembilan,21,6,7,4,38,27,65,B
2015,8301,Female,Kedah,16,6,5,3,30,23,53,C
2015,8302,Male,Sarawak,20,5,6,1,32,27,59,C
2018,8303,Male,Terengganu,21,3,3,5,32,31,63,B
2018,8304,Female,Sabah,17,8,8,2,35,37,72,B
2014,8305,Male,Kedah,19,3,10,2,34,26,60,B
2015,8306,Female,Kedah,17,8,8,3,36,35,71,B
2018,8307,Male,Terengganu,17,5,7,3,32,27,59,C
2017,8308,Female,Kelantan,21,8,7,2,38,26,64,B
2013,8309,Male,Pahang,20,8,5,4,37,36,73,B
2013,8310,Female,Pahang,19,9,3,3,34,24,58,C
2014,8311,Male,Sarawak,21,6,5,3,35,26,61,B
2018,8312,Male,Pahang,15,4,6,2,27,38,65,B
2013,8313,Male,Perak,17,5,4,1,27,28,55,C
2019,8314,Female,Sarawak,17,9,9,3,38,23,61,B
2018,8315,Male,Terengganu,14,8,10,3,35,29,64,B
2012,8316,Male,Negeri Sembilan,20,5,9,1,35,38,73,B
2012,8317,Female,Malacca,18,5,5,5,33,36,69,B
2012,8318,Male,Kedah,18,8,7,1,34,28,62,B
2017,8319,Male,Perak,13,4,3,5,25,28,53,C
2019,8320,Female,Malacca,17,9,8,1,35,38,73,B
2019,8321,Male,Sarawak,17,6,4,5,32,29,61,B
2017,8322,Male,Selangor,16,5,6,3,30,34,64,B
2017,8323,Male,Sabah,16,3,4,5,28,28,56,C
2018,8324,Female,Selangor,14,5,7,5,31,28,59,C
2017,8325,Female,Terengganu,17,8,5,2,32,28,60,B
2016,8326,Male,Kedah,15,8,4,4,31,31,62,B
2017,8327,Female,Pahang,19,6,7,1,33,27,60,B
2015,8328,Female,Penang,16,8,8,4,36,24,60,B
2012,8329,Male,Johor,21,9,6,5,41,26,67,B
2016,8330,Female,Malacca,16,3,10,5,34,37,71,B
2018,8331,Female,Perak,19,9,7,2,37,28,65,B
2018,8332,Female,Perlis,19,4,9,4,36,39,75,B
2015,8333,Female,Malacca,19,10,4,2,35,29,64,B
2014,8334,Male,Perlis,15,7,9,4,35,32,67,B
2015,8335,Female,Kedah,17,4,8,1,30,39,69,B
2017,8336,Female,Selangor,17,5,7,2,31,26,57,C
2016,8337,Male,Negeri Sembilan,17,10,7,3,37,23,60,B
2015,8338,Male,Perak,15,3,10,1,29,22,51,C
2012,8339,Male,Pahang,16,3,9,3,31,23,54,C
2017,8340,Female,Sarawak,13,10,4,4,31,32,63,B
2015,8341,Female,Negeri Sembilan,17,3,8,5,33,23,56,C
2016,8342,Female,Sabah,19,7,6,4,36,25,61,B
2014,8343,Female,Malacca,13,3,3,5,24,34,58,C
2019,8344,Male,Sarawak,20,4,10,4,38,22,60,B
2019,8345,Male,Negeri Sembilan,18,3,7,5,33,40,73,B
2014,8346,Female,Selangor,17,3,5,5,30,26,56,C
2013,8347,Male,Selangor,21,6,8,3,38,31,69,B
2016,8348,Female,Pahang,20,10,3,2,35,38,73,B
2012,8349,Female,Selangor,20,10,6,3,39,35,74,B
2015,8350,Female,Perak,16,3,3,5,27,27,54,C
2012,8351,Male,Pahang,19,10,6,4,39,28,67,B
2014,8352,Male,Negeri Sembilan,19,4,7,1,31,37,68,B
2017,8353,Female,Sabah,21,8,9,3,41,32,73,B
2012,8354,Male,Malacca,15,9,5,4,33,24,57,C
2018,8355,Male,Penang,19,7,5,1,32,35,67,B
2013,8356,Male,Selangor,16,6,3,4,29,23,52,C
2016,8357,Male,Kedah,20,7,5,1,33,39,72,B
2015,8358,Male,Sarawak,21,4,8,4,37,37,74,B
2019,8359,Male,Negeri Sembilan,14,6,9,2,31,24,55,C
2015,8360,Female,Penang,13,8,4,4,29,25,54,C
2018,8361,Male,Johor,20,10,7,3,40,33,73,B
2015,8362,Female,Johor,14,7,6,1,28,30,58,C
2016,8363,Male,Sabah,21,10,8,3,42,28,70,B
2019,8364,Female,Johor,19,8,7,1,35,22,57,C
2012,8365,Female,Penang,14,9,7,2,32,24,56,C
2019,8366,Male,Kelantan,20,10,3,3,36,28,64,B
2018,8367,Female,Kedah,21,9,9,4,43,26,69,B
2013,8368,Male,Kedah,17,4,4,1,26,23,49,F
2017,8369,Male,Negeri Sembilan,21,7,6,3,37,23,60,B
2013,8370,Female,Sarawak,14,8,7,1,30,31,61,B
2019,8371,Female,Perlis,18,4,4,4,30,30,60,B
2015,8372,Male,Perak,14,10,7,1,32,25,57,C
2016,8373,Female,Selangor,19,4,3,2,28,25,53,C
2019,8374,Female,Kedah,20,3,3,1,27,35,62,B
2019,8375,Female,Johor,13,9,9,1,32,25,57,C
2014,8376,Male,Perak,21,9,6,2,38,40,78,B
2016,8377,Female,Perlis,17,9,5,4,35,36,71,B
2017,8378,Male,Terengganu,14,6,9,3,32,32,64,B
2012,8379,Male,Negeri Sembilan,20,5,8,2,35,26,61,B
2016,8380,Female,Sabah,21,10,9,3,43,25,68,B
2019,8381,Male,Pahang,14,10,9,1,34,23,57,C
2016,8382,Female,Sabah,13,10,10,1,34,23,57,C
2014,8383,Male,Terengganu,20,8,3,5,36,26,62,B
2019,8384,Female,Perak,19,8,5,2,34,39,73,B
2015,8385,Female,Selangor,16,4,6,3,29,33,62,B
2016,8386,Male,Terengganu,14,7,5,1,27,22,49,F
2019,8387,Female,Kelantan,13,9,6,1,29,40,69,B
2018,8388,Male,Kedah,18,8,8,1,35,22,57,C
2016,8389,Female,Sarawak,16,5,4,5,30,34,64,B
2012,8390,Female,Johor,21,8,8,4,41,37,78,B
2016,8391,Female,Selangor,17,10,9,3,39,38,77,B
2012,8392,Female,Negeri Sembilan,21,3,5,3,32,23,55,C
2012,8393,Male,Perlis,17,9,4,3,33,23,56,C
2017,8394,Female,Penang,14,4,4,1,23,34,57,C
2016,8395,Male,Kelantan,19,8,8,1,36,30,66,B
2019,8396,Female,Malacca,13,6,8,2,29,27,56,C
2019,8397,Male,Penang,17,10,3,3,33,28,61,B
2018,8398,Male,Selangor,13,8,7,3,31,40,71,B
2016,8399,Male,Penang,17,6,10,1,34,35,69,B
2018,8400,Male,Penang,18,4,3,5,30,35,65,B
2017,8401,Male,Sarawak,21,7,6,2,36,32,68,B
2012,8402,Male,Perak,16,3,7,5,31,34,65,B
2016,8403,Female,Perak,18,4,3,1,26,40,66,B
2012,8404,Female,Perak,18,6,5,5,34,23,57,C
2014,8405,Male,Sarawak,21,7,4,4,36,23,59,C
2016,8406,Female,Sarawak,14,10,4,2,30,24,54,C
2013,8407,Female,Perlis,14,5,6,3,28,27,55,C
2019,8408,Female,Terengganu,16,9,8,5,38,23,61,B
2016,8409,Female,Terengganu,17,5,7,5,34,39,73,B
2019,8410,Male,Selangor,21,7,10,5,43,22,65,B
2013,8411,Female,Johor,13,6,4,3,26,30,56,C
2012,8412,Female,Terengganu,18,4,9,1,32,34,66,B
2015,8413,Male,Kelantan,18,10,9,2,39,25,64,B
2018,8414,Male,Malacca,20,9,3,4,36,33,69,B
2013,8415,Male,Pahang,18,10,9,5,42,22,64,B
2014,8416,Female,Pahang,14,7,5,3,29,26,55,C
2015,8417,Female,Malacca,13,5,3,5,26,29,55,C
2016,8418,Male,Perlis,21,4,3,3,31,25,56,C
2018,8419,Male,Pahang,21,8,6,1,36,23,59,C
2013,8420,Male,Perlis,17,7,10,2,36,35,71,B
2017,8421,Female,Selangor,20,6,4,3,33,30,63,B
2016,8422,Male,Kelantan,15,3,7,1,26,35,61,B
2013,8423,Male,Sarawak,18,6,4,1,29,34,63,B
2012,8424,Male,Malacca,20,8,4,4,36,24,60,B
2012,8425,Female,Perlis,20,10,10,2,42,25,67,B
2014,8426,Female,Perlis,13,6,7,5,31,37,68,B
2018,8427,Male,Kedah,14,4,10,2,30,26,56,C
2014,8428,Male,Kelantan,21,8,10,5,44,34,78,B
2014,8429,Male,Selangor,18,6,6,1,31,34,65,B
2017,8430,Female,Penang,14,8,5,5,32,35,67,B
2019,8431,Male,Kedah,17,7,3,2,29,30,59,C
2015,8432,Male,Malacca,14,5,10,5,34,38,72,B
2014,8433,Male,Sarawak,14,9,8,3,34,36,70,B
2014,8434,Female,Malacca,14,10,7,1,32,33,65,B
2015,8435,Female,Penang,15,4,6,3,28,39,67,B
2015,8436,Male,Pahang,17,4,9,3,33,39,72,B
2015,8437,Female,Kelantan,19,9,8,2,38,23,61,B
2012,8438,Male,Sabah,16,9,4,5,34,29,63,B
2018,8439,Male,Perlis,17,10,7,4,38,30,68,B
2018,8440,Male,Sarawak,15,4,10,1,30,37,67,B
2014,8441,Female,Kelantan,13,7,9,1,30,38,68,B
2019,8442,Male,Kelantan,19,5,5,5,34,30,64,B
2013,8443,Male,Kedah,19,9,10,2,40,23,63,B
2013,8444,Female,Sarawak,19,3,9,5,36,29,65,B
2019,8445,Female,Negeri Sembilan,19,10,9,1,39,39,78,B
2016,8446,Female,Pahang,18,6,8,3,35,31,66,B
2019,8447,Male,Pahang,21,10,8,1,40,23,63,B
2018,8448,Male,Perak,16,6,5,2,29,39,68,B
2014,8449,Female,Sarawak,14,3,9,3,29,27,56,C
2019,8450,Female,Terengganu,21,7,10,1,39,39,78,B
2019,8451,Female,Malacca,17,9,5,1,32,25,57,C
2014,8452,Female,Penang,21,5,3,3,32,29,61,B
2014,8453,Male,Sabah,18,6,6,1,31,36,67,B
2017,8454,Male,Pahang,17,5,6,1,29,38,67,B
2012,8455,Female,Perak,20,10,9,5,44,37,81,A
2019,8456,Female,Malacca,21,9,3,2,35,33,68,B
2016,8457,Male,Pahang,14,10,5,2,31,25,56,C
2017,8458,Female,Negeri Sembilan,17,7,10,5,39,33,72,B
2017,8459,Female,Kedah,21,4,9,4,38,27,65,B
2017,8460,Female,Perak,16,6,7,4,33,29,62,B
2013,8461,Male,Perak,14,5,10,2,31,24,55,C
2012,8462,Female,Penang,20,7,8,5,40,29,69,B
2012,8463,Male,Negeri Sembilan,19,8,6,1,34,29,63,B
2016,8464,Male,Perlis,15,6,7,5,33,31,64,B
2012,8465,Female,Kedah,15,9,6,5,35,40,75,B
2015,8466,Female,Selangor,16,5,10,3,34,27,61,B
2014,8467,Female,Selangor,13,10,8,2,33,28,61,B
2017,8468,Female,Penang,20,8,8,5,41,39,80,A
2017,8469,Female,Kelantan,19,8,8,5,40,25,65,B
2013,8470,Male,Perak,17,7,10,3,37,38,75,B
2019,8471,Male,Penang,15,5,9,4,33,34,67,B
2013,8472,Female,Terengganu,13,8,4,2,27,25,52,C
2016,8473,Female,Negeri Sembilan,17,3,10,2,32,24,56,C
2019,8474,Male,Johor,18,4,3,3,28,36,64,B
2014,8475,Male,Terengganu,19,7,4,1,31,25,56,C
2015,8476,Male,Kelantan,16,7,4,2,29,38,67,B
2012,8477,Male,Malacca,19,3,3,2,27,34,61,B
2014,8478,Male,Pahang,21,4,7,3,35,34,69,B
2013,8479,Female,Malacca,17,7,4,5,33,37,70,B
2013,8480,Female,Perak,13,3,10,4,30,33,63,B
2016,8481,Male,Perak,13,7,3,2,25,40,65,B
2012,8482,Female,Perak,21,6,6,2,35,34,69,B
2012,8483,Male,Sarawak,20,8,9,5,42,30,72,B
2019,8484,Female,Malacca,13,9,5,4,31,30,61,B
2013,8485,Female,Pahang,19,6,5,3,33,27,60,B
2017,8486,Female,Selangor,14,10,7,3,34,30,64,B
2017,8487,Female,Kedah,21,3,9,1,34,24,58,C
2015,8488,Female,Kedah,14,9,6,5,34,29,63,B
2016,8489,Female,Terengganu,17,9,6,4,36,31,67,B
2014,8490,Female,Johor,19,5,6,3,33,40,73,B
2019,8491,Female,Sarawak,14,7,5,3,29,35,64,B
2015,8492,Male,Penang,14,7,5,5,31,38,69,B
2013,8493,Female,Negeri Sembilan,19,9,7,3,38,22,60,B
2019,8494,Female,Johor,21,5,10,3,39,36,75,B
2015,8495,Female,Negeri Sembilan,15,5,6,4,30,35,65,B
2013,8496,Female,Sarawak,13,8,3,2,26,35,61,B
2016,8497,Male,Negeri Sembilan,14,7,3,2,26,31,57,C
2019,8498,Male,Perak,21,4,7,1,33,34,67,B
2012,8499,Female,Sarawak,16,7,5,5,33,38,71,B
2015,8500,Male,Malacca,20,8,6,1,35,32,67,B
2012,8501,Male,Terengganu,19,5,3,5,32,25,57,C
2015,8502,Male,Negeri Sembilan,18,6,5,3,32,22,54,C
2017,8503,Male,Negeri Sembilan,13,6,9,1,29,37,66,B
2015,8504,Female,Perlis,18,6,9,4,37,28,65,B
2018,8505,Female,Terengganu,14,9,6,1,30,25,55,C
2013,8506,Male,Perlis,15,6,6,1,28,35,63,B
2019,8507,Male,Sarawak,20,3,5,3,31,37,68,B
2016,8508,Male,Pahang,16,7,5,5,33,31,64,B
2018,8509,Male,Kedah,20,7,8,5,40,37,77,B
2016,8510,Female,Sarawak,17,9,3,1,30,29,59,C
2019,8511,Male,Kelantan,18,3,9,3,33,29,62,B
2015,8512,Male,Penang,13,3,6,2,24,24,48,F
2013,8513,Male,Kedah,14,8,6,3,31,31,62,B
2015,8514,Male,Kedah,14,3,6,3,26,35,61,B
2019,8515,Female,Sarawak,21,10,7,5,43,36,79,A
2014,8516,Male,Johor,15,9,5,5,34,36,70,B
2017,8517,Male,Terengganu,19,4,4,5,32,40,72,B
2016,8518,Male,Kedah,17,5,4,5,31,37,68,B
2013,8519,Male,Malacca,20,7,4,2,33,25,58,C
2016,8520,Male,Penang,21,5,9,3,38,22,60,B
2016,8521,Female,Negeri Sembilan,14,7,4,2,27,28,55,C
2012,8522,Female,Kelantan,21,4,10,4,39,29,68,B
2019,8523,Female,Sarawak,21,7,10,5,43,24,67,B
2016,8524,Male,Kelantan,15,4,8,3,30,28,58,C
2018,8525,Female,Sabah,17,7,6,4,34,33,67,B
2017,8526,Female,Johor,19,7,7,5,38,34,72,B
2014,8527,Female,Pahang,20,4,7,2,33,35,68,B
2015,8528,Male,Kelantan,16,3,5,4,28,36,64,B
2014,8529,Male,Selangor,14,10,7,5,36,27,63,B
2014,8530,Male,Sabah,18,3,6,3,30,22,52,C
2013,8531,Female,Sarawak,14,3,10,2,29,27,56,C
2012,8532,Male,Selangor,13,6,3,2,24,32,56,C
2012,8533,Male,Kedah,16,9,3,3,31,27,58,C
2016,8534,Male,Terengganu,21,10,4,5,40,32,72,B
2015,8535,Male,Perak,18,10,8,2,38,33,71,B
2014,8536,Male,Terengganu,16,6,6,5,33,33,66,B
2012,8537,Female,Pahang,17,6,5,5,33,25,58,C
2014,8538,Male,Kedah,18,8,10,2,38,23,61,B
2019,8539,Female,Penang,13,3,3,2,21,35,56,C
2013,8540,Male,Kelantan,17,9,8,3,37,29,66,B
2019,8541,Female,Sabah,21,4,8,5,38,32,70,B
2015,8542,Female,Negeri Sembilan,21,5,3,1,30,22,52,C
2018,8543,Male,Sarawak,21,5,9,4,39,26,65,B
2016,8544,Female,Kedah,14,9,7,1,31,26,57,C
2019,8545,Female,Perak,14,7,7,3,31,35,66,B
2015,8546,Male,Malacca,15,4,3,1,23,28,51,C
2013,8547,Female,Sarawak,18,9,5,1,33,37,70,B
2014,8548,Female,Sarawak,17,9,6,4,36,32,68,B
2012,8549,Male,Johor,20,5,7,1,33,34,67,B
2016,8550,Male,Sabah,17,9,10,3,39,24,63,B
2019,8551,Female,Negeri Sembilan,21,3,8,1,33,29,62,B
2012,8552,Male,Penang,20,9,4,4,37,22,59,C
2017,8553,Male,Negeri Sembilan,15,4,3,5,27,25,52,C
2017,8554,Male,Perlis,20,7,3,4,34,29,63,B
2013,8555,Male,Perlis,13,5,5,4,27,30,57,C
2017,8556,Male,Kelantan,14,10,10,2,36,38,74,B
2013,8557,Male,Johor,16,5,10,2,33,36,69,B
2018,8558,Female,Sabah,16,7,5,5,33,30,63,B
2016,8559,Male,Kedah,16,3,9,1,29,30,59,C
2019,8560,Male,Pahang,20,4,10,3,37,31,68,B
2016,8561,Male,Terengganu,20,10,10,2,42,35,77,B
2012,8562,Male,Terengganu,13,8,5,1,27,26,53,C
2012,8563,Male,Pahang,13,4,5,1,23,23,46,F
2013,8564,Male,Terengganu,17,4,7,2,30,36,66,B
2018,8565,Male,Selangor,20,4,4,5,33,29,62,B
2012,8566,Male,Malacca,19,3,6,3,31,26,57,C
2014,8567,Female,Pahang,14,4,9,4,31,36,67,B
2015,8568,Female,Perak,13,4,4,3,24,29,53,C
2019,8569,Female,Pahang,15,8,5,3,31,37,68,B
2019,8570,Female,Sabah,15,6,8,5,34,29,63,B
2013,8571,Male,Perak,21,7,5,4,37,27,64,B
2012,8572,Female,Sarawak,17,7,9,5,38,32,70,B
2013,8573,Male,Perak,16,5,6,4,31,39,70,B
2012,8574,Female,Perak,17,4,5,1,27,37,64,B
2013,8575,Female,Selangor,20,8,4,2,34,38,72,B
2018,8576,Female,Kelantan,14,9,5,1,29,37,66,B
2018,8577,Male,Perak,15,8,6,5,34,30,64,B
2018,8578,Male,Malacca,16,3,7,5,31,40,71,B
2014,8579,Female,Perlis,18,3,9,1,31,23,54,C
2019,8580,Male,Penang,14,8,7,3,32,34,66,B
2014,8581,Female,Terengganu,13,3,3,1,20,40,60,B
2014,8582,Female,Malacca,14,7,5,3,29,34,63,B
2012,8583,Female,Perak,16,9,5,5,35,26,61,B
2012,8584,Female,Perlis,18,9,4,5,36,38,74,B
2014,8585,Female,Sarawak,18,9,7,5,39,25,64,B
2016,8586,Male,Selangor,21,8,7,3,39,39,78,B
2012,8587,Male,Sabah,13,7,4,5,29,40,69,B
2014,8588,Male,Johor,21,4,10,1,36,39,75,B
2014,8589,Female,Johor,15,5,3,5,28,22,50,C
2018,8590,Male,Sabah,17,9,3,2,31,36,67,B
2013,8591,Male,Penang,17,4,9,2,32,27,59,C
2012,8592,Male,Sarawak,15,7,9,5,36,31,67,B
2017,8593,Male,Sabah,16,9,10,1,36,22,58,C
2012,8594,Female,Selangor,18,8,7,3,36,25,61,B
2018,8595,Female,Selangor,14,6,10,5,35,40,75,B
2017,8596,Male,Negeri Sembilan,14,8,3,3,28,29,57,C
2018,8597,Male,Terengganu,19,3,4,2,28,29,57,C
2013,8598,Male,Penang,17,8,8,2,35,23,58,C
2015,8599,Female,Negeri Sembilan,19,5,10,2,36,38,74,B
2019,8600,Male,Perlis,19,7,5,5,36,32,68,B
2012,8601,Male,Sabah,17,10,6,1,34,25,59,C
2017,8602,Male,Malacca,20,7,6,1,34,31,65,B
2014,8603,Male,Selangor,16,7,5,3,31,27,58,C
2012,8604,Female,Selangor,14,4,5,5,28,28,56,C
2017,8605,Male,Penang,16,7,5,4,32,38,70,B
2019,8606,Female,Terengganu,18,10,9,3,40,22,62,B
2012,8607,Male,Perak,18,5,8,1,32,29,61,B
2019,8608,Female,Kelantan,18,5,6,3,32,33,65,B
2015,8609,Female,Selangor,21,5,7,2,35,27,62,B
2012,8610,Female,Selangor,19,6,6,5,36,32,68,B
2012,8611,Female,Perlis,21,9,6,4,40,24,64,B
2018,8612,Female,Perak,19,9,6,3,37,29,66,B
2018,8613,Male,Perlis,14,3,9,1,27,38,65,B
2019,8614,Female,Selangor,17,3,4,1,25,39,64,B
2014,8615,Female,Selangor,14,8,5,2,29,35,64,B
2016,8616,Male,Kelantan,16,5,10,3,34,38,72,B
2015,8617,Female,Negeri Sembilan,19,6,10,1,36,24,60,B
2012,8618,Male,Sarawak,15,3,5,5,28,37,65,B
2019,8619,Male,Johor,18,10,4,5,37,28,65,B
2013,8620,Female,Penang,17,3,9,3,32,29,61,B
2017,8621,Male,Perak,16,10,10,4,40,32,72,B
2015,8622,Male,Perlis,18,9,10,2,39,39,78,B
2016,8623,Female,Selangor,18,9,7,5,39,29,68,B
2017,8624,Female,Johor,18,6,7,5,36,31,67,B
2013,8625,Male,Selangor,19,5,5,3,32,36,68,B
2016,8626,Male,Kelantan,21,6,10,5,42,36,78,B
2015,8627,Male,Perak,18,3,7,4,32,23,55,C
2018,8628,Male,Negeri Sembilan,19,3,8,5,35,40,75,B
2018,8629,Male,Sabah,17,8,6,5,36,38,74,B
2012,8630,Female,Johor,17,5,10,4,36,37,73,B
2016,8631,Male,Kedah,16,10,6,5,37,26,63,B
2015,8632,Female,Pahang,14,7,9,5,35,38,73,B
2015,8633,Female,Negeri Sembilan,15,10,4,1,30,30,60,B
2015,8634,Female,Terengganu,15,5,10,1,31,22,53,C
2019,8635,Female,Selangor,21,6,4,5,36,37,73,B
2012,8636,Female,Negeri Sembilan,20,3,6,2,31,29,60,B
2018,8637,Male,Sabah,21,7,6,2,36,35,71,B
2017,8638,Male,Malacca,19,8,5,1,33,31,64,B
2019,8639,Male,Perak,14,9,5,5,33,27,60,B
2014,8640,Male,Perlis,19,4,5,1,29,40,69,B
2016,8641,Female,Kelantan,15,3,8,1,27,28,55,C
2013,8642,Male,Negeri Sembilan,21,10,5,4,40,34,74,B
2018,8643,Male,Malacca,13,4,4,1,22,23,45,F
2017,8644,Male,Sarawak,13,5,6,2,26,36,62,B
2018,8645,Female,Sabah,20,5,8,3,36,33,69,B
2012,8646,Female,Malacca,20,4,3,5,32,39,71,B
2015,8647,Male,Johor,19,10,5,1,35,34,69,B
2019,8648,Female,Kedah,13,3,9,2,27,23,50,C
2015,8649,Female,Sabah,21,8,7,3,39,24,63,B
2018,8650,Female,Kedah,14,7,7,4,32,40,72,B
2013,8651,Male,Perak,16,5,9,2,32,33,65,B
2014,8652,Male,Pahang,17,4,6,2,29,24,53,C
2015,8653,Male,Kedah,18,6,4,4,32,24,56,C
2019,8654,Male,Selangor,18,4,9,1,32,27,59,C
2017,8655,Male,Kedah,20,9,3,5,37,22,59,C
2018,8656,Female,Terengganu,17,6,7,2,32,30,62,B
2012,8657,Female,Johor,18,9,3,3,33,32,65,B
2019,8658,Male,Selangor,15,5,9,2,31,22,53,C
2019,8659,Male,Perak,19,3,5,2,29,39,68,B
2014,8660,Female,Perak,19,7,9,3,38,31,69,B
2014,8661,Male,Perlis,14,8,8,2,32,27,59,C
2015,8662,Male,Terengganu,20,4,8,4,36,29,65,B
2017,8663,Male,Negeri Sembilan,18,8,3,2,31,34,65,B
2017,8664,Male,Sabah,13,6,4,4,27,26,53,C
2014,8665,Female,Sabah,19,10,8,2,39,25,64,B
2018,8666,Male,Terengganu,14,9,10,4,37,36,73,B
2017,8667,Male,Selangor,21,8,6,1,36,35,71,B
2012,8668,Female,Negeri Sembilan,19,10,7,4,40,35,75,B
2014,8669,Female,Negeri Sembilan,14,5,9,1,29,37,66,B
2015,8670,Female,Sabah,20,10,5,4,39,36,75,B
2012,8671,Female,Pahang,18,8,4,1,31,23,54,C
2012,8672,Male,Pahang,19,8,4,3,34,38,72,B
2013,8673,Male,Terengganu,14,8,7,5,34,38,72,B
2013,8674,Female,Sarawak,18,6,9,5,38,23,61,B
2017,8675,Female,Pahang,19,8,6,4,37,37,74,B
2016,8676,Male,Selangor,15,6,9,3,33,38,71,B
2019,8677,Male,Selangor,21,4,6,1,32,34,66,B
2012,8678,Male,Sarawak,14,5,10,1,30,34,64,B
2012,8679,Female,Sarawak,21,4,7,4,36,38,74,B
2013,8680,Female,Selangor,13,5,3,2,23,35,58,C
2013,8681,Male,Perlis,14,4,10,3,31,34,65,B
2013,8682,Female,Sabah,20,3,3,5,31,34,65,B
2013,8683,Female,Pahang,18,10,10,5,43,38,81,A
2012,8684,Female,Perlis,17,8,10,3,38,24,62,B
2017,8685,Male,Perlis,21,6,5,3,35,30,65,B
2018,8686,Female,Terengganu,20,5,10,4,39,23,62,B
2012,8687,Male,Kelantan,20,3,9,4,36,33,69,B
2017,8688,Female,Negeri Sembilan,19,3,3,5,30,38,68,B
2017,8689,Male,Sarawak,16,8,4,4,32,40,72,B
2012,8690,Female,Selangor,18,8,5,3,34,35,69,B
2017,8691,Male,Kedah,18,5,7,3,33,26,59,C
2017,8692,Female,Sabah,19,9,5,5,38,38,76,B
2016,8693,Male,Kelantan,16,6,6,1,29,34,63,B
2012,8694,Female,Selangor,21,10,7,3,41,40,81,A
2015,8695,Male,Pahang,21,9,4,4,38,36,74,B
2019,8696,Female,Sabah,16,8,3,3,30,22,52,C
2017,8697,Female,Johor,16,6,8,2,32,30,62,B
2013,8698,Female,Pahang,18,8,7,2,35,39,74,B
2014,8699,Male,Negeri Sembilan,19,5,10,2,36,29,65,B
2014,8700,Female,Sarawak,17,8,9,4,38,34,72,B
2017,8701,Male,Kelantan,17,9,5,2,33,37,70,B
2015,8702,Female,Pahang,17,3,9,2,31,36,67,B
2016,8703,Male,Selangor,18,9,4,1,32,32,64,B
2016,8704,Male,Penang,16,7,3,5,31,33,64,B
2015,8705,Male,Pahang,17,3,8,3,31,24,55,C
2018,8706,Male,Selangor,19,9,6,5,39,27,66,B
2014,8707,Female,Negeri Sembilan,20,8,10,2,40,40,80,A
2019,8708,Male,Johor,20,4,5,3,32,36,68,B
2018,8709,Male,Negeri Sembilan,20,9,10,5,44,34,78,B
2017,8710,Female,Kedah,21,8,3,1,33,31,64,B
2012,8711,Male,Pahang,13,9,4,2,28,30,58,C
2017,8712,Male,Sabah,20,10,6,3,39,39,78,B
2015,8713,Female,Johor,17,3,10,5,35,29,64,B
2015,8714,Female,Terengganu,15,3,4,1,23,32,55,C
2012,8715,Female,Terengganu,14,10,6,5,35,24,59,C
2014,8716,Female,Sabah,18,10,5,5,38,28,66,B
2013,8717,Male,Penang,14,6,6,5,31,37,68,B
2019,8718,Female,Pahang,16,3,4,1,24,26,50,C
2014,8719,Male,Pahang,21,6,7,4,38,40,78,B
2019,8720,Male,Kedah,14,10,7,1,32,22,54,C
2019,8721,Male,Johor,13,8,7,5,33,40,73,B
2015,8722,Male,Kedah,21,9,10,1,41,37,78,B
2016,8723,Male,Kedah,19,6,5,5,35,27,62,B
2012,8724,Male,Perak,17,7,7,3,34,35,69,B
2013,8725,Female,Selangor,16,5,5,3,29,23,52,C
2015,8726,Female,Pahang,18,5,7,1,31,22,53,C
2012,8727,Female,Johor,14,8,9,4,35,23,58,C
2019,8728,Female,Selangor,19,3,5,3,30,27,57,C
2018,8729,Male,Pahang,21,3,6,1,31,25,56,C
2012,8730,Male,Perak,16,9,8,1,34,29,63,B
2018,8731,Female,Kedah,14,5,7,2,28,33,61,B
2016,8732,Male,Pahang,17,9,6,3,35,22,57,C
2018,8733,Female,Sabah,14,8,9,3,34,22,56,C
2018,8734,Male,Kelantan,13,8,4,2,27,31,58,C
2019,8735,Male,Perlis,13,3,6,2,24,34,58,C
2015,8736,Female,Selangor,21,8,9,2,40,33,73,B
2019,8737,Female,Penang,14,7,9,5,35,28,63,B
2013,8738,Female,Kedah,21,7,8,1,37,31,68,B
2013,8739,Male,Malacca,13,10,7,5,35,38,73,B
2013,8740,Male,Sabah,13,9,4,5,31,40,71,B
2015,8741,Male,Negeri Sembilan,15,5,5,2,27,31,58,C
2016,8742,Male,Sabah,18,6,10,3,37,28,65,B
2015,8743,Male,Selangor,17,6,3,5,31,39,70,B
2019,8744,Male,Kedah,16,4,10,3,33,39,72,B
2019,8745,Female,Johor,20,7,10,2,39,38,77,B
2015,8746,Female,Sabah,18,5,3,3,29,37,66,B
2015,8747,Female,Terengganu,20,9,6,3,38,36,74,B
2015,8748,Female,Perak,21,8,4,3,36,36,72,B
2015,8749,Female,Pahang,19,8,8,1,36,23,59,C
2015,8750,Male,Sabah,14,5,5,3,27,35,62,B
2017,8751,Male,Kedah,16,4,10,2,32,25,57,C
2012,8752,Female,Perak,16,7,4,5,32,31,63,B
2019,8753,Female,Selangor,16,10,9,3,38,23,61,B
2018,8754,Female,Terengganu,17,8,7,3,35,35,70,B
2014,8755,Female,Perlis,13,6,6,5,30,30,60,B
2015,8756,Female,Malacca,18,3,3,1,25,25,50,C
2013,8757,Male,Johor,19,10,6,4,39,30,69,B
2018,8758,Female,Johor,14,5,6,3,28,36,64,B
2012,8759,Male,Perlis,14,4,9,5,32,23,55,C
2015,8760,Male,Negeri Sembilan,16,6,6,4,32,38,70,B
2012,8761,Male,Sabah,14,3,7,3,27,39,66,B
2013,8762,Male,Johor,15,4,8,5,32,24,56,C
2014,8763,Female,Johor,15,8,10,4,37,23,60,B
2017,8764,Female,Johor,21,9,5,4,39,30,69,B
2014,8765,Female,Terengganu,14,4,10,4,32,32,64,B
2013,8766,Male,Kedah,18,4,5,2,29,39,68,B
2014,8767,Male,Johor,18,5,10,1,34,33,67,B
2015,8768,Male,Sarawak,14,4,9,5,32,34,66,B
2012,8769,Male,Pahang,20,4,5,4,33,38,71,B
2018,8770,Male,Kedah,21,7,7,2,37,40,77,B
2019,8771,Female,Negeri Sembilan,18,7,8,4,37,25,62,B
2019,8772,Male,Kedah,17,6,9,3,35,26,61,B
2018,8773,Female,Selangor,14,3,6,2,25,40,65,B
2013,8774,Male,Malacca,17,9,7,2,35,24,59,C
2013,8775,Female,Sabah,20,7,10,1,38,40,78,B
2019,8776,Male,Perlis,15,7,3,2,27,25,52,C
2015,8777,Female,Perlis,13,4,4,4,25,23,48,F
2015,8778,Male,Malacca,17,3,10,1,31,29,60,B
2013,8779,Female,Sabah,19,5,7,1,32,33,65,B
2015,8780,Female,Negeri Sembilan,13,3,8,3,27,25,52,C
2013,8781,Female,Kelantan,14,9,10,3,36,24,60,B
2014,8782,Female,Malacca,14,9,3,1,27,26,53,C
2014,8783,Male,Kelantan,20,9,9,1,39,24,63,B
2018,8784,Male,Terengganu,20,8,6,4,38,27,65,B
2015,8785,Male,Perak,16,7,9,3,35,31,66,B
2012,8786,Male,Kelantan,19,8,8,1,36,22,58,C
2013,8787,Female,Sabah,20,6,9,5,40,33,73,B
2015,8788,Male,Sabah,15,8,8,5,36,27,63,B
2019,8789,Female,Selangor,20,5,6,5,36,37,73,B
2013,8790,Female,Negeri Sembilan,14,6,5,1,26,39,65,B
2016,8791,Male,Johor,15,4,6,3,28,38,66,B
2018,8792,Male,Perlis,15,10,10,3,38,36,74,B
2013,8793,Male,Perlis,21,10,10,5,46,27,73,B
2015,8794,Female,Selangor,14,3,9,5,31,35,66,B
2018,8795,Female,Selangor,17,5,8,4,34,31,65,B
2015,8796,Female,Perak,21,8,8,1,38,38,76,B
2013,8797,Female,Johor,14,8,4,2,28,30,58,C
2014,8798,Female,Johor,17,8,5,1,31,38,69,B
2019,8799,Male,Pahang,20,6,10,3,39,28,67,B
2015,8800,Female,Terengganu,20,8,4,1,33,23,56,C
2013,8801,Male,Negeri Sembilan,19,4,10,5,38,29,67,B
2019,8802,Male,Selangor,20,9,8,1,38,24,62,B
2019,8803,Female,Sabah,13,3,5,4,25,27,52,C
2015,8804,Female,Pahang,15,8,3,4,30,31,61,B
2015,8805,Female,Selangor,17,8,8,4,37,28,65,B
2016,8806,Male,Sarawak,13,5,10,1,29,33,62,B
2014,8807,Female,Perlis,17,6,10,4,37,37,74,B
2015,8808,Male,Kelantan,18,7,10,1,36,29,65,B
2013,8809,Male,Johor,14,6,7,1,28,25,53,C
2015,8810,Male,Sabah,13,4,7,5,29,30,59,C
2015,8811,Male,Selangor,18,8,8,2,36,28,64,B
2015,8812,Female,Malacca,21,4,5,5,35,33,68,B
2019,8813,Female,Pahang,14,8,4,4,30,39,69,B
2014,8814,Female,Sarawak,21,9,3,3,36,28,64,B
2018,8815,Female,Johor,21,5,8,2,36,37,73,B
2013,8816,Male,Sarawak,15,3,6,5,29,39,68,B
2015,8817,Male,Pahang,21,8,4,4,37,35,72,B
2016,8818,Male,Selangor,14,9,6,2,31,36,67,B
2019,8819,Female,Perak,17,7,6,4,34,23,57,C
2018,8820,Female,Kedah,16,5,8,3,32,40,72,B
2017,8821,Female,Penang,20,9,8,1,38,34,72,B
2018,8822,Female,Perlis,15,3,10,3,31,25,56,C
2014,8823,Male,Perlis,13,7,6,5,31,32,63,B
2019,8824,Male,Terengganu,15,9,3,5,32,29,61,B
2014,8825,Female,Pahang,17,10,3,5,35,31,66,B
2015,8826,Female,Malacca,13,3,10,3,29,34,63,B
2018,8827,Male,Sabah,18,5,7,5,35,30,65,B
2012,8828,Male,Perak,13,9,3,3,28,30,58,C
2018,8829,Male,Johor,17,8,3,1,29,33,62,B
2016,8830,Female,Malacca,20,9,4,1,34,32,66,B
2017,8831,Male,Sarawak,19,9,3,3,34,31,65,B
2018,8832,Male,Kedah,20,10,9,2,41,26,67,B
2017,8833,Male,Terengganu,14,3,8,3,28,25,53,C
2016,8834,Male,Malacca,21,8,3,1,33,35,68,B
2018,8835,Female,Malacca,19,4,10,4,37,30,67,B
2016,8836,Female,Penang,19,5,7,1,32,35,67,B
2019,8837,Male,Negeri Sembilan,13,4,8,3,28,24,52,C
2019,8838,Female,Sarawak,14,6,5,5,30,31,61,B
2015,8839,Female,Kelantan,13,5,7,4,29,30,59,C
2015,8840,Female,Negeri Sembilan,18,3,4,3,28,26,54,C
2012,8841,Female,Sarawak,17,10,10,3,40,40,80,A
2013,8842,Female,Sabah,13,5,5,3,26,32,58,C
2016,8843,Female,Sarawak,15,7,5,5,32,30,62,B
2019,8844,Male,Malacca,14,10,6,5,35,22,57,C
2019,8845,Male,Perak,19,7,7,2,35,26,61,B
2016,8846,Female,Johor,15,3,8,3,29,25,54,C
2019,8847,Male,Kelantan,14,3,4,4,25,37,62,B
2013,8848,Female,Penang,21,10,4,5,40,23,63,B
2018,8849,Female,Terengganu,19,5,3,2,29,39,68,B
2013,8850,Male,Kelantan,15,6,7,2,30,40,70,B
2014,8851,Female,Negeri Sembilan,17,10,5,3,35,29,64,B
2018,8852,Male,Negeri Sembilan,19,8,8,2,37,39,76,B
2018,8853,Male,Penang,20,6,5,5,36,33,69,B
2016,8854,Female,Malacca,14,4,3,5,26,22,48,F
2018,8855,Male,Selangor,15,10,4,2,31,27,58,C
2019,8856,Male,Sabah,21,10,4,1,36,26,62,B
2015,8857,Male,Penang,14,3,7,3,27,29,56,C
2015,8858,Female,Sabah,16,3,10,2,31,22,53,C
2018,8859,Female,Penang,21,3,9,4,37,39,76,B
2017,8860,Male,Perak,19,3,9,2,33,32,65,B
2015,8861,Female,Sarawak,13,4,5,1,23,31,54,C
2014,8862,Female,Perlis,19,6,6,2,33,28,61,B
2015,8863,Male,Selangor,16,9,7,2,34,40,74,B
2019,8864,Male,Sarawak,16,5,9,2,32,37,69,B
2018,8865,Female,Sarawak,19,3,4,2,28,25,53,C
2017,8866,Female,Penang,18,8,7,2,35,22,57,C
2013,8867,Female,Penang,15,10,6,1,32,28,60,B
2014,8868,Female,Sarawak,16,7,8,4,35,22,57,C
2013,8869,Female,Johor,20,5,3,1,29,34,63,B
2013,8870,Male,Pahang,18,9,4,4,35,37,72,B
2019,8871,Female,Malacca,18,3,4,1,26,30,56,C
2015,8872,Female,Terengganu,13,8,4,5,30,24,54,C
2019,8873,Female,Perak,14,5,8,4,31,33,64,B
2019,8874,Female,Penang,19,3,8,4,34,24,58,C
2016,8875,Female,Johor,13,6,7,3,29,25,54,C
2017,8876,Female,Kelantan,13,5,10,5,33,31,64,B
2019,8877,Female,Pahang,16,8,4,1,29,33,62,B
2015,8878,Female,Terengganu,14,4,6,2,26,32,58,C
2012,8879,Male,Johor,19,8,6,1,34,25,59,C
2017,8880,Male,Johor,16,8,3,5,32,38,70,B
2012,8881,Female,Perak,15,6,5,1,27,34,61,B
2017,8882,Male,Perak,18,3,9,4,34,40,74,B
2019,8883,Female,Johor,20,7,10,4,41,34,75,B
2015,8884,Female,Penang,14,8,7,2,31,27,58,C
2015,8885,Female,Selangor,16,10,8,1,35,22,57,C
2016,8886,Female,Perlis,18,10,9,5,42,36,78,B
2013,8887,Female,Pahang,15,4,5,2,26,25,51,C
2012,8888,Male,Penang,16,7,6,4,33,27,60,B
2013,8889,Female,Penang,14,10,10,1,35,38,73,B
2012,8890,Female,Sarawak,20,8,6,5,39,28,67,B
2017,8891,Female,Perlis,18,3,9,3,33,29,62,B
2015,8892,Male,Pahang,14,5,8,5,32,36,68,B
2015,8893,Female,Terengganu,17,4,6,1,28,26,54,C
2017,8894,Female,Johor,19,9,3,2,33,33,66,B
2014,8895,Male,Pahang,14,4,7,4,29,31,60,B
2013,8896,Female,Pahang,20,8,3,2,33,22,55,C
2013,8897,Female,Penang,19,6,6,2,33,24,57,C
2014,8898,Female,Pahang,19,5,6,3,33,29,62,B
2012,8899,Female,Sarawak,21,4,10,5,40,34,74,B
2013,8900,Female,Perak,19,6,6,5,36,36,72,B
2014,8901,Female,Malacca,14,7,6,1,28,23,51,C
2016,8902,Male,Malacca,21,6,5,1,33,22,55,C
2012,8903,Female,Perak,18,9,10,4,41,37,78,B
2019,8904,Male,Kelantan,17,10,6,1,34,35,69,B
2014,8905,Male,Penang,18,9,8,5,40,31,71,B
2013,8906,Female,Kedah,17,6,10,3,36,23,59,C
2015,8907,Female,Johor,15,7,4,5,31,28,59,C
2012,8908,Male,Selangor,16,8,7,5,36,34,70,B
2017,8909,Male,Sabah,20,10,7,2,39,23,62,B
2014,8910,Male,Johor,20,5,6,1,32,38,70,B
2019,8911,Male,Terengganu,14,3,5,5,27,39,66,B
2013,8912,Male,Negeri Sembilan,18,3,8,1,30,33,63,B
2018,8913,Female,Pahang,13,7,9,4,33,22,55,C
2013,8914,Female,Sabah,21,7,9,2,39,39,78,B
2015,8915,Female,Johor,20,4,3,1,28,37,65,B
2015,8916,Male,Selangor,15,7,9,5,36,30,66,B
2012,8917,Male,Pahang,21,6,9,2,38,25,63,B
2016,8918,Male,Terengganu,13,5,10,3,31,35,66,B
2017,8919,Male,Johor,18,5,10,2,35,27,62,B
2015,8920,Female,Terengganu,18,3,9,4,34,25,59,C
2012,8921,Female,Pahang,15,5,7,5,32,29,61,B
2017,8922,Male,Penang,14,6,9,4,33,27,60,B
2015,8923,Male,Negeri Sembilan,13,5,6,5,29,38,67,B
2017,8924,Female,Terengganu,16,4,3,2,25,35,60,B
2013,8925,Male,Perlis,21,10,5,4,40,37,77,B
2017,8926,Female,Selangor,19,10,5,1,35,32,67,B
2012,8927,Male,Pahang,13,3,9,3,28,23,51,C
2015,8928,Female,Perlis,13,7,8,1,29,36,65,B
2013,8929,Male,Pahang,19,4,4,2,29,26,55,C
2016,8930,Female,Malacca,19,8,10,3,40,25,65,B
2015,8931,Female,Malacca,21,7,7,1,36,26,62,B
2013,8932,Female,Penang,16,6,5,5,32,35,67,B
2019,8933,Female,Negeri Sembilan,21,7,3,3,34,33,67,B
2012,8934,Male,Sarawak,19,7,4,1,31,39,70,B
2018,8935,Male,Sabah,18,5,4,3,30,25,55,C
2017,8936,Male,Perlis,14,9,10,3,36,31,67,B
2019,8937,Male,Sabah,20,8,4,3,35,30,65,B
2016,8938,Female,Sarawak,14,4,5,2,25,40,65,B
2018,8939,Male,Selangor,17,3,3,2,25,24,49,F
2019,8940,Male,Johor,19,9,3,1,32,33,65,B
2015,8941,Female,Sarawak,18,7,5,1,31,35,66,B
2016,8942,Male,Kedah,16,6,6,3,31,38,69,B
2017,8943,Male,Malacca,21,7,4,1,33,28,61,B
2014,8944,Male,Pahang,21,7,3,3,34,22,56,C
2017,8945,Male,Sarawak,16,10,4,5,35,35,70,B
2018,8946,Female,Sarawak,17,5,3,5,30,26,56,C
2017,8947,Male,Selangor,21,7,10,4,42,35,77,B
2012,8948,Female,Penang,16,4,3,3,26,28,54,C
2014,8949,Female,Johor,13,4,4,2,23,40,63,B
2013,8950,Male,Malacca,14,8,10,4,36,32,68,B
2015,8951,Female,Negeri Sembilan,20,3,9,1,33,37,70,B
2018,8952,Female,Kedah,21,4,8,2,35,22,57,C
2015,8953,Male,Kelantan,20,4,5,4,33,40,73,B
2018,8954,Female,Sabah,17,4,3,1,25,22,47,F
2013,8955,Male,Terengganu,14,7,10,3,34,30,64,B
2019,8956,Female,Penang,13,10,3,1,27,32,59,C
2012,8957,Female,Malacca,13,5,3,4,25,40,65,B
2015,8958,Male,Kedah,17,3,6,1,27,37,64,B
2014,8959,Male,Perlis,14,4,3,3,24,30,54,C
2014,8960,Male,Selangor,13,4,3,3,23,26,49,F
2015,8961,Female,Johor,20,4,7,5,36,22,58,C
2013,8962,Male,Kelantan,17,6,7,4,34,38,72,B
2014,8963,Male,Sabah,19,5,3,5,32,38,70,B
2018,8964,Male,Perak,18,5,8,3,34,31,65,B
2016,8965,Male,Kelantan,14,6,10,2,32,29,61,B
2017,8966,Male,Negeri Sembilan,19,10,4,4,37,31,68,B
2014,8967,Female,Perak,18,7,3,2,30,37,67,B
2014,8968,Male,Penang,13,3,7,2,25,32,57,C
2015,8969,Female,Perak,19,3,3,3,28,38,66,B
2015,8970,Female,Sabah,17,4,5,2,28,31,59,C
2015,8971,Female,Sabah,14,7,3,5,29,32,61,B
2014,8972,Male,Perak,20,3,3,4,30,31,61,B
2017,8973,Female,Malacca,20,8,10,1,39,23,62,B
2018,8974,Female,Perlis,18,10,6,5,39,33,72,B
2012,8975,Female,Terengganu,21,5,5,1,32,30,62,B
2014,8976,Female,Kelantan,19,10,9,1,39,24,63,B
2013,8977,Male,Terengganu,16,7,8,2,33,35,68,B
2019,8978,Male,Perlis,13,4,3,1,21,25,46,F
2019,8979,Male,Pahang,18,10,4,2,34,35,69,B
2016,8980,Male,Malacca,17,8,4,4,33,25,58,C
2019,8981,Female,Selangor,14,6,8,2,30,37,67,B
2018,8982,Male,Perlis,19,7,10,5,41,25,66,B
2019,8983,Female,Perak,14,4,9,2,29,29,58,C
2019,8984,Female,Sarawak,20,8,3,5,36,24,60,B
2012,8985,Female,Malacca,17,10,4,4,35,30,65,B
2012,8986,Male,Johor,17,6,4,5,32,22,54,C
2015,8987,Male,Kedah,20,4,3,4,31,33,64,B
2016,8988,Male,Sarawak,14,3,5,5,27,29,56,C
2012,8989,Female,Negeri Sembilan,13,3,6,1,23,32,55,C
2017,8990,Male,Negeri Sembilan,21,9,3,1,34,32,66,B
2019,8991,Female,Selangor,15,8,5,3,31,34,65,B
2018,8992,Female,Sabah,18,8,5,3,34,32,66,B
2013,8993,Male,Pahang,21,8,5,1,35,32,67,B
2019,8994,Male,Penang,20,5,10,5,40,26,66,B
2014,8995,Female,Johor,20,8,7,1,36,22,58,C
2016,8996,Male,Kelantan,18,9,5,3,35,31,66,B
2016,8997,Female,Negeri Sembilan,15,6,9,4,34,36,70,B
2018,8998,Female,Sarawak,16,6,5,5,32,38,70,B
2018,8999,Male,Kedah,20,6,9,2,37,22,59,C
2019,9000,Female,Johor,13,6,5,2,26,27,53,C
2018,9001,Female,Negeri Sembilan,13,9,4,3,29,36,65,B
2012,9002,Male,Penang,18,5,10,2,35,27,62,B
2019,9003,Male,Perlis,13,3,4,3,23,29,52,C
2013,9004,Male,Johor,14,5,9,4,32,26,58,C
2012,9005,Male,Perak,18,6,5,3,32,33,65,B
2016,9006,Female,Johor,17,5,5,1,28,35,63,B
2017,9007,Female,Penang,15,5,10,4,34,24,58,C
2018,9008,Female,Pahang,20,9,3,5,37,22,59,C
2012,9009,Male,Johor,13,4,4,2,23,27,50,C
2015,9010,Male,Sarawak,17,10,9,5,41,27,68,B
2013,9011,Female,Kedah,16,7,5,2,30,24,54,C
2013,9012,Male,Sarawak,21,4,3,2,30,38,68,B
2019,9013,Female,Sabah,13,8,6,4,31,40,71,B
2012,9014,Male,Sarawak,21,5,10,2,38,30,68,B
2015,9015,Male,Perlis,13,5,3,2,23,32,55,C
2019,9016,Female,Negeri Sembilan,18,8,8,2,36,37,73,B
2016,9017,Male,Pahang,16,5,8,4,33,26,59,C
2017,9018,Female,Kelantan,19,7,6,5,37,24,61,B
2014,9019,Female,Malacca,21,8,10,5,44,33,77,B
2016,9020,Female,Perlis,14,5,9,5,33,30,63,B
2017,9021,Female,Sarawak,15,8,4,5,32,33,65,B
2017,9022,Male,Malacca,14,4,3,1,22,33,55,C
2014,9023,Male,Negeri Sembilan,19,9,6,2,36,35,71,B
2018,9024,Male,Johor,20,5,3,2,30,37,67,B
2019,9025,Female,Malacca,15,5,10,2,32,25,57,C
2015,9026,Male,Kedah,19,8,5,3,35,36,71,B
2019,9027,Female,Johor,17,5,10,4,36,27,63,B
2012,9028,Female,Sabah,18,5,5,5,33,26,59,C
2015,9029,Male,Kelantan,15,8,8,4,35,36,71,B
2016,9030,Male,Terengganu,20,6,9,1,36,36,72,B
2012,9031,Female,Johor,13,9,9,3,34,29,63,B
2015,9032,Male,Sabah,16,10,9,1,36,29,65,B
2018,9033,Female,Perak,15,4,10,3,32,37,69,B
2019,9034,Female,Terengganu,20,6,4,5,35,31,66,B
2014,9035,Male,Johor,19,7,5,5,36,30,66,B
2015,9036,Female,Selangor,17,6,9,1,33,33,66,B
2017,9037,Female,Perak,21,10,5,1,37,24,61,B
2013,9038,Male,Perak,19,4,9,4,36,31,67,B
2019,9039,Female,Negeri Sembilan,16,7,3,4,30,22,52,C
2019,9040,Male,Sabah,13,10,8,4,35,24,59,C
2016,9041,Male,Sabah,14,10,3,3,30,22,52,C
2015,9042,Male,Negeri Sembilan,19,7,3,4,33,34,67,B
2018,9043,Male,Perak,17,10,6,4,37,24,61,B
2015,9044,Male,Sabah,19,4,10,5,38,31,69,B
2013,9045,Male,Terengganu,14,9,9,4,36,40,76,B
2017,9046,Male,Perlis,16,5,3,1,25,37,62,B
2016,9047,Male,Perlis,14,6,7,3,30,37,67,B
2017,9048,Female,Kedah,18,7,8,4,37,29,66,B
2015,9049,Female,Sabah,14,5,10,4,33,33,66,B
2018,9050,Male,Terengganu,21,9,4,2,36,33,69,B
2013,9051,Female,Perlis,17,4,5,2,28,33,61,B
2018,9052,Male,Perak,16,4,5,4,29,23,52,C
2017,9053,Male,Terengganu,17,4,5,4,30,39,69,B
2012,9054,Male,Terengganu,18,5,7,1,31,31,62,B
2013,9055,Male,Kedah,18,7,5,1,31,32,63,B
2019,9056,Male,Johor,20,6,8,2,36,34,70,B
2016,9057,Female,Sabah,16,3,3,5,27,25,52,C
2019,9058,Female,Kelantan,13,4,10,1,28,30,58,C
2012,9059,Female,Penang,18,8,10,2,38,28,66,B
2018,9060,Male,Kelantan,15,7,8,2,32,40,72,B
2019,9061,Female,Sarawak,20,7,4,1,32,37,69,B
2012,9062,Male,Kedah,16,8,8,1,33,28,61,B
2017,9063,Female,Terengganu,21,8,9,3,41,35,76,B
2018,9064,Female,Penang,18,10,10,1,39,33,72,B
2019,9065,Female,Pahang,14,8,10,4,36,39,75,B
2012,9066,Male,Johor,13,8,6,5,32,28,60,B
2019,9067,Male,Negeri Sembilan,13,10,9,5,37,28,65,B
2012,9068,Female,Pahang,19,9,3,5,36,31,67,B
2018,9069,Male,Kedah,21,4,10,1,36,36,72,B
2017,9070,Male,Sarawak,16,8,4,3,31,34,65,B
2012,9071,Female,Pahang,18,10,10,1,39,37,76,B
2013,9072,Male,Sabah,18,6,5,2,31,39,70,B
2018,9073,Male,Terengganu,21,5,3,5,34,29,63,B
2014,9074,Male,Selangor,17,4,3,1,25,22,47,F
2012,9075,Male,Selangor,18,9,7,1,35,34,69,B
2018,9076,Female,Perlis,18,3,10,4,35,34,69,B
2016,9077,Female,Penang,17,6,5,3,31,39,70,B
2014,9078,Male,Pahang,17,3,10,1,31,23,54,C
2014,9079,Female,Kelantan,20,9,8,1,38,23,61,B
2019,9080,Male,Negeri Sembilan,19,3,3,2,27,27,54,C
2012,9081,Male,Sabah,13,6,5,4,28,26,54,C
2014,9082,Female,Sabah,21,7,5,4,37,35,72,B
2015,9083,Female,Perlis,18,8,3,1,30,39,69,B
2013,9084,Female,Kelantan,13,9,5,3,30,26,56,C
2019,9085,Male,Kelantan,20,3,6,2,31,33,64,B
2015,9086,Male,Sabah,17,10,6,3,36,33,69,B
2012,9087,Female,Malacca,20,4,10,5,39,39,78,B
2014,9088,Female,Perak,16,9,4,5,34,28,62,B
2012,9089,Female,Selangor,20,8,6,5,39,36,75,B
2019,9090,Male,Malacca,18,10,7,3,38,33,71,B
2019,9091,Male,Kelantan,19,8,7,3,37,28,65,B
2018,9092,Female,Perlis,19,9,5,5,38,33,71,B
2018,9093,Female,Selangor,13,5,3,3,24,38,62,B
2019,9094,Male,Penang,14,7,4,3,28,40,68,B
2015,9095,Female,Penang,15,7,6,5,33,30,63,B
2012,9096,Female,Sarawak,13,3,4,5,25,36,61,B
2017,9097,Male,Kedah,16,10,4,1,31,37,68,B
2017,9098,Male,Terengganu,16,3,7,4,30,30,60,B
2019,9099,Female,Terengganu,21,10,3,2,36,37,73,B
2013,9100,Female,Pahang,13,3,4,2,22,28,50,C
2019,9101,Male,Penang,17,8,4,1,30,30,60,B
2019,9102,Female,Selangor,21,10,6,5,42,39,81,A
2013,9103,Female,Pahang,13,9,6,2,30,39,69,B
2016,9104,Female,Kedah,21,7,6,5,39,22,61,B
2017,9105,Male,Pahang,13,5,9,5,32,24,56,C
2018,9106,Male,Perlis,19,4,6,2,31,26,57,C
2019,9107,Male,Kedah,16,7,7,5,35,36,71,B
2016,9108,Female,Perlis,19,10,8,3,40,29,69,B
2014,9109,Male,Terengganu,15,6,3,4,28,40,68,B
2017,9110,Male,Negeri Sembilan,19,6,8,5,38,39,77,B
2012,9111,Female,Penang,18,5,6,4,33,24,57,C
2012,9112,Male,Kelantan,14,3,6,3,26,33,59,C
2013,9113,Male,Selangor,14,6,8,2,30,38,68,B
2014,9114,Female,Terengganu,15,8,10,2,35,30,65,B
2012,9115,Male,Johor,17,5,10,2,34,26,60,B
2012,9116,Male,Perlis,18,6,10,4,38,28,66,B
2018,9117,Male,Sabah,13,10,5,3,31,37,68,B
2014,9118,Female,Negeri Sembilan,19,9,5,5,38,31,69,B
2014,9119,Female,Selangor,18,3,6,4,31,34,65,B
2018,9120,Female,Perlis,15,4,7,1,27,28,55,C
2019,9121,Male,Sarawak,21,7,8,1,37,29,66,B
2016,9122,Female,Sabah,13,8,8,1,30,30,60,B
2013,9123,Female,Malacca,18,5,8,3,34,36,70,B
2019,9124,Male,Sabah,14,10,8,2,34,32,66,B
2016,9125,Female,Johor,18,5,9,1,33,31,64,B
2019,9126,Female,Johor,20,6,3,4,33,22,55,C
2019,9127,Male,Pahang,17,3,5,4,29,32,61,B
2014,9128,Female,Negeri Sembilan,16,8,8,1,33,30,63,B
2019,9129,Female,Pahang,20,5,5,4,34,35,69,B
2015,9130,Female,Kedah,18,3,8,5,34,35,69,B
2012,9131,Female,Perak,15,4,6,5,30,40,70,B
2019,9132,Female,Penang,16,8,8,2,34,38,72,B
2019,9133,Female,Kelantan,18,9,3,4,34,38,72,B
2017,9134,Female,Perak,20,10,3,5,38,36,74,B
2018,9135,Female,Pahang,18,4,8,2,32,35,67,B
2014,9136,Female,Kelantan,15,10,10,1,36,38,74,B
2019,9137,Male,Kelantan,14,10,4,2,30,22,52,C
2019,9138,Male,Kedah,18,7,10,2,37,34,71,B
2016,9139,Male,Perlis,18,8,5,5,36,25,61,B
2017,9140,Female,Sarawak,19,3,4,2,28,39,67,B
2014,9141,Male,Kedah,18,7,8,5,38,40,78,B
2013,9142,Female,Perlis,21,7,6,1,35,38,73,B
2012,9143,Male,Malacca,19,10,9,2,40,25,65,B
2019,9144,Female,Penang,18,5,5,1,29,27,56,C
2015,9145,Female,Terengganu,17,5,9,2,33,31,64,B
2015,9146,Male,Kelantan,20,6,10,3,39,35,74,B
2019,9147,Male,Penang,14,7,4,2,27,25,52,C
2015,9148,Female,Penang,14,3,10,3,30,40,70,B
2014,9149,Male,Sarawak,18,4,9,3,34,24,58,C
2018,9150,Female,Kelantan,16,3,8,5,32,24,56,C
2017,9151,Male,Perak,13,6,5,4,28,22,50,C
2016,9152,Female,Terengganu,20,9,8,5,42,32,74,B
2017,9153,Female,Kelantan,14,10,8,1,33,27,60,B
2016,9154,Male,Sarawak,13,5,10,1,29,40,69,B
2013,9155,Male,Kedah,20,7,8,3,38,34,72,B
2015,9156,Female,Kedah,17,4,3,3,27,34,61,B
2016,9157,Male,Kelantan,20,6,5,3,34,40,74,B
2016,9158,Female,Pahang,14,5,6,5,30,34,64,B
2015,9159,Female,Kelantan,18,3,10,3,34,32,66,B
2018,9160,Female,Sarawak,13,4,3,4,24,38,62,B
2016,9161,Male,Penang,13,8,6,4,31,39,70,B
2012,9162,Male,Perlis,16,7,10,1,34,34,68,B
2019,9163,Female,Malacca,17,9,9,4,39,40,79,A
2019,9164,Male,Sarawak,19,4,4,2,29,30,59,C
2018,9165,Male,Penang,15,10,4,3,32,28,60,B
2019,9166,Male,Perak,21,9,4,3,37,25,62,B
2015,9167,Female,Negeri Sembilan,21,3,6,4,34,35,69,B
2019,9168,Female,Perak,16,4,9,2,31,40,71,B
2014,9169,Male,Johor,15,4,10,5,34,24,58,C
2013,9170,Female,Perlis,20,9,10,5,44,34,78,B
2017,9171,Male,Kedah,20,5,5,5,35,32,67,B
2017,9172,Female,Kelantan,19,3,5,3,30,37,67,B
2012,9173,Male,Negeri Sembilan,19,8,3,1,31,29,60,B
2013,9174,Female,Pahang,20,5,5,3,33,33,66,B
2012,9175,Female,Kedah,13,9,7,1,30,34,64,B
2015,9176,Male,Kedah,15,4,6,4,29,40,69,B
2014,9177,Male,Sarawak,17,4,7,1,29,29,58,C
2016,9178,Male,Kelantan,13,10,7,4,34,27,61,B
2013,9179,Female,Selangor,20,7,9,2,38,34,72,B
2018,9180,Male,Malacca,13,3,5,1,22,35,57,C
2012,9181,Female,Sarawak,18,5,3,3,29,23,52,C
2015,9182,Male,Sarawak,16,8,10,5,39,36,75,B
2013,9183,Female,Johor,17,8,7,5,37,33,70,B
2013,9184,Female,Negeri Sembilan,14,10,6,3,33,30,63,B
2018,9185,Female,Negeri Sembilan,13,7,8,5,33,25,58,C
2018,9186,Male,Negeri Sembilan,14,10,7,5,36,39,75,B
2012,9187,Male,Penang,20,5,4,3,32,23,55,C
2014,9188,Female,Malacca,14,5,7,2,28,31,59,C
2017,9189,Female,Sarawak,13,10,8,2,33,33,66,B
2017,9190,Female,Sabah,15,10,8,1,34,23,57,C
2018,9191,Female,Perak,19,3,4,2,28,30,58,C
2016,9192,Male,Malacca,15,8,4,2,29,39,68,B
2019,9193,Female,Malacca,16,7,9,5,37,36,73,B
2018,9194,Male,Kedah,15,8,9,3,35,27,62,B
2017,9195,Male,Johor,16,9,7,2,34,35,69,B
2014,9196,Female,Penang,18,5,9,1,33,34,67,B
2015,9197,Male,Sarawak,18,9,8,2,37,29,66,B
2018,9198,Female,Pahang,15,10,6,4,35,38,73,B
2017,9199,Male,Perak,14,3,3,3,23,23,46,F
2013,9200,Male,Kedah,17,5,7,1,30,28,58,C
2013,9201,Male,Perlis,15,3,9,4,31,28,59,C
2019,9202,Female,Negeri Sembilan,20,5,9,2,36,33,69,B
2016,9203,Female,Kedah,15,4,4,1,24,31,55,C
2012,9204,Male,Perak,13,7,6,4,30,39,69,B
2012,9205,Female,Kelantan,14,9,5,3,31,27,58,C
2017,9206,Female,Sarawak,21,10,6,4,41,34,75,B
2016,9207,Female,Johor,15,10,10,2,37,38,75,B
2019,9208,Male,Kedah,21,4,4,2,31,39,70,B
2014,9209,Female,Sabah,14,8,5,1,28,40,68,B
2012,9210,Male,Negeri Sembilan,17,4,7,3,31,22,53,C
2016,9211,Female,Pahang,16,8,9,3,36,32,68,B
2018,9212,Male,Perlis,15,7,7,3,32,25,57,C
2012,9213,Female,Kelantan,19,9,3,3,34,34,68,B
2012,9214,Female,Kelantan,13,3,8,1,25,25,50,C
2013,9215,Male,Penang,15,5,4,5,29,29,58,C
2014,9216,Male,Selangor,14,8,8,4,34,32,66,B
2019,9217,Male,Sabah,16,5,7,5,33,28,61,B
2015,9218,Male,Sabah,20,8,8,2,38,28,66,B
2019,9219,Male,Perak,19,4,5,3,31,34,65,B
2018,9220,Female,Kedah,16,9,3,5,33,34,67,B
2012,9221,Male,Kedah,20,3,4,2,29,24,53,C
2019,9222,Female,Penang,18,7,6,5,36,30,66,B
2017,9223,Female,Negeri Sembilan,18,6,8,4,36,36,72,B
2012,9224,Female,Pahang,16,10,9,2,37,35,72,B
2017,9225,Male,Terengganu,15,7,8,2,32,39,71,B
2014,9226,Male,Sabah,19,3,6,4,32,35,67,B
2014,9227,Male,Terengganu,16,9,6,5,36,37,73,B
2016,9228,Male,Selangor,17,7,8,1,33,29,62,B
2013,9229,Male,Perak,14,6,9,1,30,27,57,C
2017,9230,Female,Johor,18,6,7,2,33,34,67,B
2017,9231,Female,Sabah,15,5,3,1,24,23,47,F
2018,9232,Female,Sabah,14,7,4,1,26,24,50,C
2017,9233,Female,Malacca,21,7,5,3,36,22,58,C
2014,9234,Female,Sarawak,17,8,6,2,33,39,72,B
2015,9235,Female,Penang,21,6,9,2,38,29,67,B
2016,9236,Male,Kedah,17,3,7,1,28,29,57,C
2018,9237,Female,Perlis,13,10,8,4,35,31,66,B
2015,9238,Female,Penang,14,10,10,2,36,35,71,B
2016,9239,Male,Perlis,14,8,6,4,32,22,54,C
2019,9240,Male,Perlis,20,3,9,1,33,40,73,B
2014,9241,Female,Negeri Sembilan,14,10,6,1,31,30,61,B
2012,9242,Female,Kelantan,17,5,5,1,28,26,54,C
2018,9243,Male,Sabah,16,10,8,4,38,33,71,B
2014,9244,Male,Perak,13,6,6,3,28,28,56,C
2013,9245,Female,Perlis,20,5,5,2,32,37,69,B
2018,9246,Female,Perlis,17,8,9,3,37,31,68,B
2015,9247,Male,Malacca,21,7,6,1,35,40,75,B
2017,9248,Female,Sabah,18,4,10,3,35,29,64,B
2015,9249,Female,Kedah,19,7,6,4,36,27,63,B
2012,9250,Female,Kedah,20,8,3,1,32,27,59,C
2013,9251,Female,Perak,21,9,3,5,38,24,62,B
2018,9252,Male,Pahang,16,5,10,1,32,32,64,B
2015,9253,Male,Sarawak,19,7,7,2,35,36,71,B
2016,9254,Female,Sabah,15,7,10,3,35,39,74,B
2015,9255,Female,Malacca,14,3,3,4,24,32,56,C
2014,9256,Male,Negeri Sembilan,17,4,5,5,31,37,68,B
2018,9257,Female,Sabah,13,4,5,3,25,23,48,F
2016,9258,Female,Malacca,21,7,10,2,40,34,74,B
2015,9259,Male,Pahang,16,8,6,5,35,38,73,B
2012,9260,Male,Selangor,16,7,7,5,35,36,71,B
2017,9261,Female,Selangor,20,7,5,5,37,31,68,B
2019,9262,Male,Negeri Sembilan,15,3,3,3,24,28,52,C
2017,9263,Male,Perak,14,8,4,3,29,25,54,C
2015,9264,Female,Sabah,16,10,10,4,40,32,72,B
2012,9265,Female,Kedah,16,7,8,5,36,22,58,C
2012,9266,Female,Perlis,15,10,8,4,37,28,65,B
2012,9267,Female,Kelantan,13,7,8,2,30,34,64,B
2015,9268,Female,Selangor,15,7,3,1,26,33,59,C
2016,9269,Male,Negeri Sembilan,16,3,7,4,30,35,65,B
2014,9270,Male,Negeri Sembilan,17,3,10,1,31,33,64,B
2015,9271,Female,Negeri Sembilan,13,5,6,2,26,29,55,C
2017,9272,Male,Sarawak,17,9,8,1,35,22,57,C
2013,9273,Female,Penang,16,10,6,2,34,31,65,B
2019,9274,Male,Selangor,13,3,9,4,29,22,51,C
2018,9275,Female,Selangor,15,7,10,1,33,32,65,B
2019,9276,Male,Pahang,21,10,3,2,36,22,58,C
2014,9277,Female,Selangor,18,4,9,3,34,27,61,B
2018,9278,Male,Negeri Sembilan,19,10,5,4,38,39,77,B
2017,9279,Female,Sarawak,20,7,6,2,35,35,70,B
2014,9280,Female,Perlis,15,4,9,1,29,36,65,B
2015,9281,Female,Perak,16,3,4,4,27,30,57,C
2013,9282,Female,Sabah,19,6,8,2,35,28,63,B
2014,9283,Male,Johor,19,6,3,1,29,31,60,B
2017,9284,Female,Perlis,16,9,8,1,34,22,56,C
2019,9285,Female,Penang,14,3,6,1,24,36,60,B
2019,9286,Female,Sarawak,21,7,7,1,36,23,59,C
2018,9287,Female,Kelantan,13,4,6,4,27,26,53,C
2019,9288,Male,Terengganu,14,7,8,1,30,36,66,B
2012,9289,Male,Sarawak,17,7,3,4,31,22,53,C
2015,9290,Female,Kelantan,13,10,6,1,30,31,61,B
2017,9291,Male,Johor,21,9,9,4,43,34,77,B
2014,9292,Female,Terengganu,21,6,9,2,38,32,70,B
2018,9293,Male,Terengganu,20,3,8,2,33,36,69,B
2012,9294,Male,Selangor,18,4,7,1,30,35,65,B
2016,9295,Male,Selangor,13,8,4,2,27,37,64,B
2016,9296,Male,Johor,21,9,9,4,43,27,70,B
2017,9297,Female,Sarawak,19,7,6,4,36,38,74,B
2019,9298,Male,Sabah,21,6,5,2,34,34,68,B
2017,9299,Female,Perlis,14,6,9,5,34,25,59,C
2015,9300,Male,Sabah,18,9,3,2,32,37,69,B
2015,9301,Male,Johor,19,10,4,4,37,31,68,B
2014,9302,Female,Penang,18,3,10,1,32,36,68,B
2017,9303,Female,Perlis,21,8,3,5,37,39,76,B
2013,9304,Male,Terengganu,13,9,5,3,30,33,63,B
2019,9305,Female,Pahang,18,7,8,5,38,31,69,B
2018,9306,Female,Kelantan,16,10,5,5,36,28,64,B
2018,9307,Female,Perlis,18,8,7,3,36,27,63,B
2016,9308,Male,Selangor,21,5,3,3,32,32,64,B
2019,9309,Male,Sabah,18,4,4,2,28,30,58,C
2016,9310,Female,Kedah,18,3,8,2,31,29,60,B
2016,9311,Male,Negeri Sembilan,20,3,3,5,31,28,59,C
2018,9312,Female,Perak,16,8,5,4,33,27,60,B
2013,9313,Male,Negeri Sembilan,19,10,8,3,40,25,65,B
2019,9314,Male,Perlis,17,10,5,1,33,31,64,B
2018,9315,Male,Terengganu,14,9,7,3,33,32,65,B
2014,9316,Female,Kedah,18,4,5,5,32,22,54,C
2018,9317,Female,Penang,18,5,8,2,33,32,65,B
2017,9318,Female,Perak,17,8,5,1,31,26,57,C
2017,9319,Male,Perlis,15,3,9,1,28,37,65,B
2018,9320,Male,Selangor,16,5,3,3,27,36,63,B
2014,9321,Male,Selangor,14,9,6,5,34,29,63,B
2018,9322,Male,Terengganu,16,8,4,5,33,40,73,B
2017,9323,Female,Kedah,15,9,9,5,38,22,60,B
2019,9324,Male,Kedah,15,3,7,5,30,37,67,B
2019,9325,Male,Negeri Sembilan,19,8,5,1,33,28,61,B
2016,9326,Male,Selangor,16,10,5,3,34,29,63,B
2013,9327,Male,Kelantan,13,5,10,3,31,25,56,C
2017,9328,Male,Sarawak,21,8,5,3,37,39,76,B
2015,9329,Female,Selangor,15,6,5,1,27,38,65,B
2019,9330,Male,Kelantan,13,4,7,4,28,38,66,B
2017,9331,Male,Terengganu,16,5,3,4,28,39,67,B
2018,9332,Female,Malacca,20,3,3,2,28,30,58,C
2016,9333,Female,Kedah,19,5,10,5,39,35,74,B
2014,9334,Female,Malacca,19,3,3,5,30,38,68,B
2013,9335,Female,Penang,19,3,6,3,31,22,53,C
2019,9336,Female,Terengganu,15,9,10,4,38,31,69,B
2014,9337,Female,Johor,18,8,4,1,31,23,54,C
2014,9338,Female,Perak,17,7,7,1,32,27,59,C
2012,9339,Female,Negeri Sembilan,15,10,4,3,32,25,57,C
2018,9340,Female,Terengganu,21,6,6,5,38,22,60,B
2012,9341,Female,Malacca,20,5,4,3,32,29,61,B
2018,9342,Female,Johor,21,10,5,2,38,26,64,B
2019,9343,Female,Sabah,13,8,9,1,31,27,58,C
2012,9344,Female,Malacca,15,6,10,3,34,30,64,B
2015,9345,Male,Negeri Sembilan,14,4,5,1,24,23,47,F
2014,9346,Female,Kedah,13,10,9,2,34,30,64,B
2013,9347,Female,Selangor,16,4,6,1,27,40,67,B
2012,9348,Female,Sabah,21,3,5,5,34,38,72,B
2015,9349,Female,Sarawak,14,4,8,5,31,24,55,C
2018,9350,Male,Perlis,14,10,5,1,30,26,56,C
2016,9351,Male,Perak,14,7,8,1,30,34,64,B
2018,9352,Female,Kedah,20,8,8,2,38,33,71,B
2014,9353,Male,Negeri Sembilan,18,9,3,4,34,24,58,C
2019,9354,Female,Selangor,15,9,3,3,30,39,69,B
2015,9355,Male,Kedah,18,5,4,5,32,35,67,B
2012,9356,Female,Pahang,19,3,8,5,35,29,64,B
2018,9357,Female,Perlis,14,6,7,3,30,38,68,B
2017,9358,Male,Kedah,16,4,6,3,29,36,65,B
2015,9359,Male,Sarawak,14,5,9,2,30,40,70,B
2013,9360,Male,Selangor,14,8,10,5,37,28,65,B
2014,9361,Male,Johor,19,4,3,4,30,37,67,B
2014,9362,Male,Sarawak,21,9,3,5,38,29,67,B
2016,9363,Male,Selangor,15,10,9,1,35,24,59,C
2014,9364,Male,Malacca,21,3,4,3,31,38,69,B
2015,9365,Female,Malacca,15,9,4,5,33,23,56,C
2017,9366,Female,Sarawak,18,6,3,1,28,32,60,B
2019,9367,Female,Perlis,15,6,10,4,35,36,71,B
2014,9368,Male,Johor,15,4,10,1,30,25,55,C
2017,9369,Female,Kelantan,15,7,10,5,37,28,65,B
2016,9370,Female,Negeri Sembilan,19,5,10,2,36,22,58,C
2018,9371,Female,Perak,13,4,3,1,21,31,52,C
2015,9372,Male,Perlis,20,3,3,1,27,36,63,B
2014,9373,Female,Penang,14,9,3,3,29,26,55,C
2015,9374,Female,Perlis,19,7,7,4,37,22,59,C
2014,9375,Female,Kelantan,21,4,4,1,30,35,65,B
2012,9376,Male,Perlis,20,9,9,3,41,34,75,B
2012,9377,Female,Selangor,13,6,6,1,26,33,59,C
2012,9378,Male,Sarawak,14,6,8,3,31,40,71,B
2017,9379,Male,Terengganu,19,3,6,1,29,31,60,B
2013,9380,Female,Perlis,14,4,7,5,30,30,60,B
2016,9381,Male,Negeri Sembilan,20,9,4,1,34,27,61,B
2016,9382,Male,Penang,20,10,4,3,37,33,70,B
2013,9383,Female,Johor,18,9,6,1,34,24,58,C
2015,9384,Female,Pahang,20,7,3,1,31,33,64,B
2018,9385,Female,Johor,21,7,6,2,36,30,66,B
2014,9386,Female,Sarawak,21,6,9,3,39,27,66,B
2014,9387,Female,Kedah,17,6,9,3,35,28,63,B
2012,9388,Female,Terengganu,18,8,9,5,40,31,71,B
2014,9389,Female,Malacca,20,8,3,5,36,37,73,B
2015,9390,Female,Sabah,21,9,7,1,38,37,75,B
2018,9391,Male,Pahang,16,4,3,4,27,37,64,B
2019,9392,Female,Perlis,17,7,3,3,30,24,54,C
2018,9393,Male,Selangor,15,3,3,4,25,37,62,B
2015,9394,Male,Terengganu,18,4,10,1,33,31,64,B
2013,9395,Female,Penang,18,4,3,1,26,27,53,C
2018,9396,Female,Perlis,21,8,10,3,42,38,80,A
2014,9397,Male,Selangor,19,7,10,2,38,29,67,B
2019,9398,Male,Sarawak,19,3,5,2,29,37,66,B
2013,9399,Male,Kedah,14,8,9,5,36,39,75,B
2017,9400,Female,Malacca,17,7,5,5,34,27,61,B
2017,9401,Male,Penang,18,4,4,3,29,40,69,B
2016,9402,Female,Selangor,14,8,9,1,32,22,54,C
2019,9403,Female,Pahang,15,6,8,3,32,35,67,B
2014,9404,Male,Pahang,20,10,9,3,42,40,82,A
2018,9405,Male,Pahang,16,6,7,5,34,35,69,B
2018,9406,Male,Pahang,17,9,9,2,37,25,62,B
2014,9407,Female,Johor,19,10,8,2,39,38,77,B
2013,9408,Male,Kelantan,18,10,10,4,42,22,64,B
2013,9409,Female,Pahang,21,4,7,3,35,39,74,B
2013,9410,Female,Malacca,14,9,6,3,32,27,59,C
2013,9411,Male,Sarawak,18,8,7,5,38,39,77,B
2018,9412,Male,Selangor,19,8,9,2,38,27,65,B
2016,9413,Male,Pahang,21,8,9,3,41,38,79,A
2017,9414,Male,Perak,16,4,8,3,31,22,53,C
2017,9415,Female,Malacca,14,8,8,3,33,29,62,B
2019,9416,Female,Pahang,16,8,9,1,34,38,72,B
2015,9417,Female,Sabah,17,3,9,3,32,23,55,C
2018,9418,Male,Negeri Sembilan,20,7,4,4,35,33,68,B
2017,9419,Male,Penang,19,6,7,2,34,27,61,B
2013,9420,Female,Pahang,13,7,5,3,28,28,56,C
2017,9421,Female,Kedah,13,6,3,2,24,27,51,C
2016,9422,Female,Johor,18,7,8,3,36,30,66,B
2017,9423,Female,Negeri Sembilan,20,4,3,1,28,28,56,C
2013,9424,Male,Kedah,13,10,5,3,31,28,59,C
2015,9425,Male,Kelantan,17,3,10,4,34,23,57,C
2019,9426,Male,Perlis,21,3,9,3,36,31,67,B
2016,9427,Male,Negeri Sembilan,21,7,7,5,40,22,62,B
2018,9428,Male,Johor,20,8,9,4,41,25,66,B
2012,9429,Female,Negeri Sembilan,16,7,9,4,36,37,73,B
2014,9430,Male,Kelantan,13,6,8,1,28,25,53,C
2015,9431,Male,Pahang,19,3,8,3,33,40,73,B
2013,9432,Female,Perlis,21,10,7,1,39,39,78,B
2017,9433,Male,Pahang,19,7,9,2,37,32,69,B
2019,9434,Female,Johor,16,8,3,2,29,23,52,C
2014,9435,Female,Pahang,13,7,10,5,35,31,66,B
2018,9436,Male,Perlis,20,8,6,1,35,22,57,C
2019,9437,Female,Sabah,13,3,7,4,27,22,49,F
2018,9438,Male,Malacca,14,9,9,2,34,28,62,B
2017,9439,Male,Penang,18,3,10,2,33,34,67,B
2016,9440,Female,Sarawak,17,10,6,1,34,39,73,B
2013,9441,Male,Kedah,19,10,3,5,37,40,77,B
2014,9442,Female,Negeri Sembilan,14,7,3,3,27,29,56,C
2019,9443,Male,Malacca,13,3,3,2,21,25,46,F
2012,9444,Male,Kedah,20,5,6,1,32,28,60,B
2012,9445,Male,Terengganu,21,10,8,2,41,31,72,B
2015,9446,Female,Selangor,18,7,3,3,31,32,63,B
2017,9447,Female,Kedah,13,7,9,1,30,24,54,C
2015,9448,Male,Negeri Sembilan,15,4,10,5,34,31,65,B
2013,9449,Female,Sarawak,21,4,10,5,40,32,72,B
2013,9450,Female,Sarawak,18,9,10,3,40,24,64,B
2015,9451,Male,Sabah,18,4,4,2,28,36,64,B
2019,9452,Female,Terengganu,18,4,4,5,31,34,65,B
2016,9453,Male,Selangor,18,6,6,2,32,38,70,B
2016,9454,Female,Malacca,14,6,7,2,29,24,53,C
2015,9455,Male,Perlis,19,7,5,3,34,27,61,B
2017,9456,Male,Selangor,18,4,7,2,31,38,69,B
2016,9457,Female,Johor,16,3,5,1,25,31,56,C
2019,9458,Male,Selangor,20,9,7,5,41,22,63,B
2014,9459,Female,Kedah,15,7,6,2,30,24,54,C
2014,9460,Female,Perlis,15,9,6,4,34,28,62,B
2016,9461,Male,Perak,14,4,5,2,25,33,58,C
2015,9462,Male,Penang,13,3,10,3,29,23,52,C
2019,9463,Female,Perlis,15,4,6,3,28,32,60,B
2016,9464,Male,Pahang,18,4,3,3,28,22,50,C
2019,9465,Female,Perlis,20,5,6,2,33,37,70,B
2013,9466,Female,Perlis,17,6,8,2,33,36,69,B
2017,9467,Male,Kedah,14,5,3,5,27,34,61,B
2014,9468,Male,Johor,13,3,9,2,27,30,57,C
2018,9469,Male,Kedah,17,10,8,2,37,30,67,B
2012,9470,Male,Johor,18,9,9,3,39,22,61,B
2016,9471,Male,Johor,14,10,9,5,38,24,62,B
2016,9472,Female,Sabah,16,9,6,3,34,28,62,B
2018,9473,Male,Pahang,17,3,7,4,31,26,57,C
2017,9474,Female,Sabah,18,5,4,1,28,29,57,C
2018,9475,Male,Kedah,17,3,5,5,30,38,68,B
2017,9476,Female,Sarawak,15,3,10,1,29,34,63,B
2015,9477,Female,Malacca,19,10,9,2,40,25,65,B
2018,9478,Female,Kelantan,20,6,3,1,30,40,70,B
2014,9479,Male,Perak,21,8,4,2,35,25,60,B
2015,9480,Female,Kelantan,13,5,5,4,27,28,55,C
2016,9481,Male,Pahang,16,8,4,2,30,27,57,C
2017,9482,Female,Kelantan,19,4,5,3,31,36,67,B
2013,9483,Female,Pahang,13,4,6,1,24,31,55,C
2014,9484,Female,Perak,16,9,7,1,33,31,64,B
2019,9485,Female,Perlis,20,6,5,1,32,28,60,B
2019,9486,Male,Sarawak,20,7,7,4,38,32,70,B
2017,9487,Male,Kelantan,20,8,9,5,42,23,65,B
2019,9488,Female,Terengganu,16,6,10,4,36,39,75,B
2012,9489,Female,Johor,20,6,9,1,36,36,72,B
2018,9490,Female,Perlis,18,7,10,2,37,33,70,B
2015,9491,Male,Kelantan,17,8,4,5,34,34,68,B
2012,9492,Male,Penang,18,6,4,4,32,34,66,B
2012,9493,Female,Johor,14,8,8,1,31,23,54,C
2016,9494,Female,Selangor,21,5,3,1,30,26,56,C
2012,9495,Female,Malacca,18,4,7,3,32,30,62,B
2019,9496,Female,Perlis,13,7,4,2,26,32,58,C
2012,9497,Female,Sarawak,20,5,6,4,35,23,58,C
2017,9498,Female,Perak,13,10,5,1,29,33,62,B
2014,9499,Female,Selangor,16,7,4,5,32,33,65,B
2015,9500,Female,Kelantan,19,6,5,1,31,23,54,C
2012,9501,Male,Perlis,14,6,10,3,33,30,63,B
2013,9502,Female,Pahang,13,10,10,2,35,22,57,C
2018,9503,Male,Perlis,20,9,6,2,37,40,77,B
2017,9504,Female,Terengganu,17,10,8,3,38,39,77,B
2018,9505,Female,Johor,15,10,6,1,32,27,59,C
2014,9506,Male,Terengganu,19,10,6,3,38,22,60,B
2017,9507,Female,Selangor,18,7,3,1,29,38,67,B
2017,9508,Male,Sabah,14,8,9,2,33,38,71,B
2015,9509,Male,Perlis,13,10,8,4,35,24,59,C
2015,9510,Female,Perlis,20,8,4,4,36,40,76,B
2017,9511,Male,Kedah,16,8,3,5,32,31,63,B
2018,9512,Female,Malacca,13,10,7,1,31,33,64,B
2018,9513,Male,Sabah,18,9,4,1,32,29,61,B
2018,9514,Female,Sarawak,16,6,9,3,34,28,62,B
2019,9515,Male,Pahang,13,7,6,1,27,23,50,C
2013,9516,Male,Kelantan,17,5,10,5,37,37,74,B
2012,9517,Female,Sarawak,14,7,10,2,33,35,68,B
2016,9518,Male,Kedah,13,8,6,2,29,25,54,C
2018,9519,Female,Selangor,13,7,3,2,25,29,54,C
2018,9520,Female,Perak,14,6,4,5,29,36,65,B
2015,9521,Male,Selangor,21,4,9,5,39,27,66,B
2015,9522,Male,Selangor,19,5,7,5,36,30,66,B
2018,9523,Male,Penang,15,8,6,3,32,26,58,C
2015,9524,Male,Johor,17,4,4,5,30,30,60,B
2015,9525,Female,Selangor,13,4,9,5,31,37,68,B
2017,9526,Female,Kelantan,19,9,6,1,35,37,72,B
2016,9527,Female,Negeri Sembilan,13,8,9,5,35,28,63,B
2017,9528,Male,Penang,17,9,7,2,35,34,69,B
2017,9529,Male,Johor,20,8,6,1,35,36,71,B
2019,9530,Female,Penang,17,7,3,5,32,30,62,B
2018,9531,Male,Selangor,18,10,8,1,37,24,61,B
2013,9532,Male,Negeri Sembilan,14,8,8,3,33,22,55,C
2013,9533,Female,Sabah,19,9,9,4,41,36,77,B
2018,9534,Female,Sarawak,18,5,9,3,35,28,63,B
2018,9535,Male,Sabah,18,10,5,5,38,31,69,B
2018,9536,Male,Negeri Sembilan,13,4,4,3,24,22,46,F
2014,9537,Male,Kelantan,14,7,9,2,32,28,60,B
2017,9538,Male,Selangor,21,3,9,3,36,24,60,B
2012,9539,Male,Kedah,14,7,9,1,31,22,53,C
2013,9540,Male,Perlis,21,5,7,1,34,29,63,B
2019,9541,Male,Terengganu,17,10,3,5,35,24,59,C
2018,9542,Female,Penang,17,7,6,5,35,23,58,C
2017,9543,Male,Kedah,21,9,7,1,38,35,73,B
2019,9544,Male,Terengganu,16,6,3,4,29,35,64,B
2014,9545,Male,Johor,18,7,5,5,35,29,64,B
2014,9546,Female,Selangor,13,4,3,4,24,24,48,F
2013,9547,Male,Negeri Sembilan,20,3,8,2,33,31,64,B
2019,9548,Female,Malacca,15,8,7,3,33,30,63,B
2017,9549,Female,Terengganu,14,9,7,1,31,35,66,B
2015,9550,Female,Kelantan,13,8,10,4,35,36,71,B
2016,9551,Female,Pahang,19,6,10,2,37,38,75,B
2014,9552,Female,Sabah,16,8,10,1,35,35,70,B
2016,9553,Male,Negeri Sembilan,16,10,8,5,39,30,69,B
2013,9554,Female,Sabah,16,5,8,4,33,38,71,B
2017,9555,Male,Perlis,21,8,7,4,40,29,69,B
2015,9556,Male,Perak,16,10,9,5,40,26,66,B
2015,9557,Male,Pahang,14,6,3,1,24,24,48,F
2018,9558,Male,Pahang,15,4,7,1,27,39,66,B
2018,9559,Male,Sarawak,17,7,5,1,30,23,53,C
2015,9560,Female,Sabah,14,5,3,3,25,36,61,B
2016,9561,Female,Perak,21,6,3,2,32,24,56,C
2016,9562,Female,Pahang,16,8,4,3,31,37,68,B
2015,9563,Male,Sabah,14,3,7,1,25,23,48,F
2014,9564,Male,Kedah,17,9,5,5,36,36,72,B
2015,9565,Male,Perak,19,3,10,5,37,23,60,B
2016,9566,Female,Malacca,20,4,9,2,35,39,74,B
2015,9567,Female,Malacca,20,5,6,1,32,34,66,B
2018,9568,Male,Johor,18,6,7,4,35,37,72,B
2012,9569,Male,Negeri Sembilan,18,5,8,1,32,26,58,C
2019,9570,Male,Johor,14,4,3,2,23,22,45,F
2019,9571,Male,Johor,20,3,5,4,32,22,54,C
2017,9572,Male,Perlis,13,7,7,4,31,35,66,B
2012,9573,Female,Negeri Sembilan,21,10,3,2,36,29,65,B
2012,9574,Female,Malacca,14,8,10,3,35,36,71,B
2019,9575,Female,Perlis,18,7,4,2,31,36,67,B
2017,9576,Female,Perak,15,3,10,3,31,22,53,C
2016,9577,Female,Perlis,17,3,10,4,34,22,56,C
2014,9578,Male,Kelantan,14,4,8,4,30,37,67,B
2014,9579,Male,Kedah,14,10,5,3,32,27,59,C
2014,9580,Male,Terengganu,18,7,5,3,33,30,63,B
2015,9581,Male,Selangor,14,9,3,2,28,40,68,B
2013,9582,Female,Kedah,19,5,5,1,30,36,66,B
2014,9583,Male,Perak,17,3,8,3,31,33,64,B
2018,9584,Female,Johor,16,3,6,4,29,33,62,B
2015,9585,Male,Sabah,21,7,8,2,38,29,67,B
2014,9586,Male,Perlis,19,9,7,5,40,32,72,B
2015,9587,Male,Malacca,18,6,4,5,33,33,66,B
2013,9588,Male,Selangor,15,7,8,1,31,38,69,B
2015,9589,Male,Negeri Sembilan,14,9,5,2,30,30,60,B
2018,9590,Female,Kedah,16,8,5,5,34,38,72,B
2014,9591,Male,Perak,18,9,5,5,37,32,69,B
2013,9592,Male,Perak,17,9,4,3,33,29,62,B
2016,9593,Male,Perak,20,3,8,4,35,31,66,B
2015,9594,Male,Selangor,21,10,6,2,39,40,79,A
2013,9595,Male,Perak,20,7,10,1,38,26,64,B
2017,9596,Male,Perlis,18,5,8,3,34,33,67,B
2015,9597,Female,Sarawak,16,3,4,1,24,23,47,F
2012,9598,Male,Terengganu,17,7,7,1,32,34,66,B
2016,9599,Male,Perak,13,6,5,2,26,22,48,F
2016,9600,Female,Selangor,15,8,8,3,34,27,61,B
2019,9601,Female,Negeri Sembilan,17,4,3,2,26,31,57,C
2014,9602,Male,Selangor,13,4,7,2,26,26,52,C
2012,9603,Female,Kedah,19,8,9,5,41,25,66,B
2012,9604,Female,Penang,21,3,4,4,32,32,64,B
2018,9605,Male,Sabah,18,5,3,1,27,25,52,C
2013,9606,Female,Sarawak,16,6,6,5,33,34,67,B
2014,9607,Male,Johor,15,8,5,2,30,28,58,C
2014,9608,Female,Kedah,14,9,7,4,34,30,64,B
2014,9609,Female,Selangor,17,8,6,3,34,38,72,B
2013,9610,Male,Pahang,16,9,8,5,38,22,60,B
2015,9611,Male,Selangor,19,6,3,3,31,26,57,C
2013,9612,Male,Sarawak,17,3,8,5,33,36,69,B
2015,9613,Female,Perak,15,7,6,1,29,33,62,B
2012,9614,Female,Terengganu,19,10,6,4,39,29,68,B
2018,9615,Female,Malacca,17,4,3,2,26,34,60,B
2015,9616,Female,Kelantan,13,6,6,5,30,29,59,C
2012,9617,Female,Penang,18,4,9,3,34,34,68,B
2016,9618,Female,Johor,14,10,4,1,29,24,53,C
2014,9619,Female,Penang,17,3,3,1,24,24,48,F
2015,9620,Male,Johor,14,5,3,5,27,30,57,C
2017,9621,Female,Selangor,13,8,9,1,31,24,55,C
2014,9622,Male,Perlis,20,10,10,3,43,26,69,B
2016,9623,Female,Penang,15,7,6,4,32,38,70,B
2013,9624,Male,Kedah,15,6,6,3,30,29,59,C
2018,9625,Female,Kelantan,17,7,9,4,37,25,62,B
2012,9626,Male,Sarawak,20,3,7,5,35,25,60,B
2013,9627,Female,Negeri Sembilan,14,6,4,5,29,32,61,B
2017,9628,Male,Perlis,13,5,8,4,30,36,66,B
2018,9629,Female,Pahang,17,7,9,3,36,23,59,C
2015,9630,Male,Negeri Sembilan,14,10,5,1,30,39,69,B
2012,9631,Male,Johor,20,10,10,1,41,30,71,B
2014,9632,Female,Penang,17,7,3,1,28,28,56,C
2017,9633,Male,Kedah,13,6,3,4,26,37,63,B
2019,9634,Female,Negeri Sembilan,17,6,7,4,34,37,71,B
2014,9635,Female,Perak,21,4,10,1,36,26,62,B
2015,9636,Male,Johor,19,3,8,1,31,23,54,C
2017,9637,Female,Malacca,15,9,4,3,31,34,65,B
2015,9638,Male,Negeri Sembilan,21,9,9,3,42,22,64,B
2017,9639,Male,Sabah,21,4,4,5,34,34,68,B
2016,9640,Male,Negeri Sembilan,19,7,7,4,37,38,75,B
2019,9641,Male,Perak,18,9,7,1,35,31,66,B
2013,9642,Female,Negeri Sembilan,17,8,9,4,38,28,66,B
2012,9643,Female,Malacca,15,7,8,4,34,39,73,B
2015,9644,Female,Negeri Sembilan,18,9,10,2,39,26,65,B
2017,9645,Female,Perak,14,8,9,2,33,22,55,C
2015,9646,Male,Terengganu,13,4,4,2,23,29,52,C
2013,9647,Female,Negeri Sembilan,14,5,5,5,29,28,57,C
2015,9648,Male,Sarawak,18,3,6,3,30,32,62,B
2012,9649,Male,Johor,15,10,3,4,32,35,67,B
2019,9650,Male,Perak,15,6,3,3,27,40,67,B
2012,9651,Male,Pahang,17,4,6,1,28,25,53,C
2019,9652,Male,Sabah,21,9,10,3,43,32,75,B
2018,9653,Male,Terengganu,15,5,8,4,32,34,66,B
2017,9654,Male,Perak,15,6,3,5,29,38,67,B
2019,9655,Female,Terengganu,19,6,8,4,37,25,62,B
2017,9656,Female,Malacca,21,4,7,4,36,32,68,B
2014,9657,Female,Pahang,17,6,7,4,34,25,59,C
2015,9658,Female,Kelantan,19,8,3,2,32,35,67,B
2016,9659,Female,Selangor,14,10,9,3,36,34,70,B
2018,9660,Male,Kelantan,15,7,3,2,27,32,59,C
2018,9661,Female,Selangor,14,10,8,2,34,39,73,B
2012,9662,Female,Kelantan,18,6,8,5,37,34,71,B
2014,9663,Female,Perak,18,5,5,4,32,22,54,C
2014,9664,Male,Pahang,19,6,10,5,40,27,67,B
2013,9665,Male,Perlis,20,5,8,3,36,39,75,B
2017,9666,Male,Perlis,15,5,5,2,27,36,63,B
2017,9667,Male,Perak,19,5,4,1,29,38,67,B
2018,9668,Female,Pahang,20,3,9,5,37,27,64,B
2019,9669,Male,Terengganu,14,6,4,4,28,28,56,C
2016,9670,Female,Perlis,13,5,4,3,25,32,57,C
2019,9671,Male,Malacca,20,9,6,1,36,28,64,B
2014,9672,Male,Sarawak,15,5,3,1,24,37,61,B
2019,9673,Female,Sabah,16,5,6,5,32,22,54,C
2014,9674,Male,Kelantan,13,4,4,2,23,36,59,C
2013,9675,Female,Terengganu,20,3,10,4,37,23,60,B
2019,9676,Male,Kelantan,18,10,3,2,33,25,58,C
2014,9677,Female,Kedah,19,3,8,3,33,27,60,B
2017,9678,Female,Sabah,13,9,4,1,27,25,52,C
2015,9679,Female,Pahang,16,10,9,3,38,27,65,B
2014,9680,Female,Terengganu,15,5,10,4,34,31,65,B
2018,9681,Female,Perlis,13,9,4,2,28,32,60,B
2019,9682,Male,Terengganu,19,8,5,1,33,36,69,B
2018,9683,Female,Johor,19,5,5,3,32,37,69,B
2012,9684,Male,Penang,20,6,8,1,35,40,75,B
2016,9685,Female,Perak,14,10,7,4,35,32,67,B
2016,9686,Female,Penang,17,3,5,1,26,29,55,C
2016,9687,Female,Perak,18,10,8,1,37,37,74,B
2012,9688,Male,Sarawak,19,8,6,3,36,26,62,B
2019,9689,Male,Negeri Sembilan,20,5,5,1,31,38,69,B
2013,9690,Male,Kelantan,21,3,4,4,32,23,55,C
2016,9691,Female,Kelantan,20,8,7,4,39,38,77,B
2012,9692,Female,Johor,14,6,6,4,30,25,55,C
2017,9693,Female,Kedah,20,3,10,5,38,39,77,B
2014,9694,Male,Perlis,15,4,9,4,32,39,71,B
2015,9695,Male,Kelantan,13,6,5,4,28,34,62,B
2017,9696,Female,Terengganu,14,4,5,3,26,31,57,C
2018,9697,Female,Kelantan,13,4,10,5,32,23,55,C
2015,9698,Male,Kedah,21,6,4,3,34,38,72,B
2015,9699,Female,Perak,13,5,5,2,25,22,47,F
2018,9700,Male,Perlis,17,8,6,1,32,35,67,B
2015,9701,Female,Perak,16,6,4,5,31,29,60,B
2013,9702,Female,Terengganu,17,7,7,1,32,22,54,C
2019,9703,Female,Malacca,13,5,9,1,28,31,59,C
2015,9704,Female,Kedah,14,9,4,1,28,31,59,C
2019,9705,Male,Selangor,14,10,8,4,36,25,61,B
2017,9706,Male,Sarawak,18,5,5,2,30,37,67,B
2017,9707,Male,Penang,16,4,4,5,29,28,57,C
2014,9708,Male,Kelantan,20,9,6,3,38,23,61,B
2017,9709,Male,Selangor,17,8,4,5,34,26,60,B
2013,9710,Male,Penang,21,8,4,3,36,29,65,B
2016,9711,Female,Kelantan,21,4,7,5,37,24,61,B
2013,9712,Male,Perlis,13,9,7,1,30,29,59,C
2017,9713,Male,Penang,21,10,4,5,40,23,63,B
2017,9714,Female,Perak,21,6,5,3,35,32,67,B
2013,9715,Female,Perlis,13,4,9,2,28,28,56,C
2012,9716,Female,Negeri Sembilan,13,3,9,3,28,28,56,C
2012,9717,Female,Pahang,16,4,5,4,29,28,57,C
2016,9718,Male,Pahang,18,6,3,1,28,22,50,C
2013,9719,Female,Malacca,18,8,7,3,36,27,63,B
2018,9720,Male,Kedah,16,9,10,1,36,27,63,B
2014,9721,Male,Terengganu,15,3,6,2,26,34,60,B
2017,9722,Female,Negeri Sembilan,19,6,4,4,33,25,58,C
2015,9723,Male,Terengganu,21,8,10,4,43,26,69,B
2016,9724,Female,Penang,14,8,4,1,27,34,61,B
2019,9725,Female,Perak,17,3,10,1,31,39,70,B
2015,9726,Male,Selangor,19,8,4,1,32,35,67,B
2016,9727,Male,Kelantan,21,9,6,3,39,26,65,B
2012,9728,Female,Sarawak,17,4,10,4,35,27,62,B
2015,9729,Female,Negeri Sembilan,13,5,5,4,27,22,49,F
2012,9730,Male,Terengganu,15,9,5,5,34,37,71,B
2016,9731,Female,Johor,14,8,6,4,32,37,69,B
2013,9732,Female,Johor,19,7,9,4,39,23,62,B
2014,9733,Female,Selangor,20,7,8,2,37,24,61,B
2019,9734,Male,Kelantan,15,8,6,3,32,25,57,C
2012,9735,Female,Perlis,20,10,10,4,44,38,82,A
2012,9736,Female,Malacca,16,10,9,3,38,31,69,B
2014,9737,Male,Penang,18,7,10,3,38,37,75,B
2019,9738,Male,Penang,18,4,4,3,29,30,59,C
2018,9739,Female,Kedah,14,9,8,1,32,23,55,C
2018,9740,Male,Perak,13,9,6,5,33,38,71,B
2012,9741,Female,Malacca,13,8,10,1,32,35,67,B
2014,9742,Female,Selangor,15,7,4,4,30,38,68,B
2012,9743,Male,Negeri Sembilan,16,5,9,2,32,25,57,C
2012,9744,Female,Johor,17,8,3,1,29,24,53,C
2016,9745,Male,Sarawak,13,8,10,5,36,37,73,B
2018,9746,Female,Johor,19,6,6,3,34,32,66,B
2012,9747,Female,Sarawak,14,4,3,4,25,39,64,B
2018,9748,Female,Terengganu,19,7,9,2,37,30,67,B
2014,9749,Female,Perak,21,3,8,5,37,37,74,B
2019,9750,Male,Selangor,21,9,8,4,42,37,79,A
2017,9751,Male,Penang,19,5,9,5,38,30,68,B
2018,9752,Female,Penang,19,7,9,2,37,24,61,B
2019,9753,Female,Johor,21,8,6,2,37,37,74,B
2012,9754,Female,Sarawak,15,4,6,3,28,38,66,B
2018,9755,Female,Penang,21,9,7,1,38,31,69,B
2017,9756,Female,Kelantan,18,9,10,1,38,36,74,B
2013,9757,Female,Negeri Sembilan,16,9,5,3,33,36,69,B
2018,9758,Female,Kedah,21,9,10,3,43,31,74,B
2012,9759,Male,Terengganu,13,6,8,3,30,28,58,C
2017,9760,Male,Johor,15,9,8,1,33,24,57,C
2014,9761,Male,Pahang,19,3,5,3,30,34,64,B
2019,9762,Male,Sabah,21,9,9,2,41,23,64,B
2013,9763,Female,Perlis,14,10,3,3,30,22,52,C
2015,9764,Male,Negeri Sembilan,17,6,5,1,29,39,68,B
2015,9765,Male,Negeri Sembilan,19,9,6,2,36,33,69,B
2012,9766,Male,Johor,14,8,7,1,30,22,52,C
2016,9767,Male,Perak,19,3,7,2,31,26,57,C
2013,9768,Male,Negeri Sembilan,17,10,7,5,39,22,61,B
2012,9769,Male,Perlis,13,10,8,4,35,39,74,B
2014,9770,Male,Pahang,15,4,8,5,32,35,67,B
2015,9771,Female,Perlis,18,6,5,3,32,40,72,B
2012,9772,Male,Perak,19,4,10,3,36,27,63,B
2015,9773,Male,Terengganu,18,4,3,2,27,32,59,C
2013,9774,Female,Sarawak,18,3,3,5,29,27,56,C
2014,9775,Female,Sarawak,16,5,7,4,32,27,59,C
2019,9776,Male,Pahang,19,7,9,1,36,40,76,B
2018,9777,Female,Negeri Sembilan,21,9,8,5,43,24,67,B
2016,9778,Male,Kedah,14,4,9,2,29,33,62,B
2013,9779,Male,Malacca,18,8,7,1,34,30,64,B
2013,9780,Female,Kelantan,19,6,10,2,37,36,73,B
2013,9781,Male,Sabah,14,3,7,5,29,24,53,C
2018,9782,Female,Kelantan,13,6,6,3,28,37,65,B
2014,9783,Male,Perlis,17,9,8,1,35,38,73,B
2018,9784,Female,Kedah,18,3,8,2,31,28,59,C
2013,9785,Female,Perak,19,9,6,1,35,29,64,B
2012,9786,Male,Perlis,13,9,4,3,29,29,58,C
2012,9787,Female,Kedah,18,7,8,4,37,38,75,B
2013,9788,Male,Sarawak,16,6,5,4,31,33,64,B
2012,9789,Male,Pahang,13,10,9,1,33,23,56,C
2017,9790,Male,Pahang,21,5,4,2,32,40,72,B
2017,9791,Male,Pahang,13,4,10,2,29,27,56,C
2014,9792,Female,Sarawak,21,6,5,2,34,29,63,B
2018,9793,Female,Perlis,17,9,8,4,38,37,75,B
2014,9794,Male,Terengganu,13,10,9,5,37,30,67,B
2012,9795,Male,Kelantan,16,5,4,1,26,28,54,C
2012,9796,Male,Negeri Sembilan,16,8,10,2,36,30,66,B
2013,9797,Male,Johor,18,4,9,3,34,31,65,B
2019,9798,Male,Perlis,16,3,8,4,31,22,53,C
2014,9799,Male,Penang,19,3,7,2,31,36,67,B
2019,9800,Male,Sarawak,21,9,4,2,36,40,76,B
2016,9801,Male,Johor,17,6,10,1,34,40,74,B
2018,9802,Female,Johor,15,8,6,3,32,34,66,B
2015,9803,Male,Sabah,19,10,4,1,34,29,63,B
2012,9804,Male,Sarawak,14,4,5,1,24,31,55,C
2019,9805,Male,Sarawak,16,5,4,1,26,25,51,C
2013,9806,Male,Penang,14,8,10,4,36,28,64,B
2012,9807,Male,Terengganu,20,6,5,4,35,27,62,B
2019,9808,Female,Kelantan,13,6,8,1,28,26,54,C
2014,9809,Female,Selangor,18,10,10,2,40,24,64,B
2016,9810,Female,Johor,15,6,9,5,35,25,60,B
2017,9811,Female,Malacca,20,9,8,4,41,32,73,B
2016,9812,Female,Penang,19,3,10,4,36,36,72,B
2016,9813,Male,Selangor,16,3,10,3,32,40,72,B
2016,9814,Male,Sabah,14,7,4,2,27,31,58,C
2018,9815,Male,Penang,18,4,5,1,28,40,68,B
2013,9816,Male,Penang,16,6,7,1,30,27,57,C
2012,9817,Male,Penang,20,6,7,5,38,36,74,B
2013,9818,Male,Kedah,18,10,4,3,35,22,57,C
2012,9819,Male,Perlis,13,5,3,4,25,22,47,F
2013,9820,Male,Kelantan,16,6,7,4,33,37,70,B
2019,9821,Female,Perlis,19,6,7,2,34,38,72,B
2015,9822,Female,Malacca,16,4,9,1,30,40,70,B
2017,9823,Male,Terengganu,17,8,6,1,32,24,56,C
2019,9824,Female,Sarawak,18,3,10,5,36,31,67,B
2016,9825,Male,Perak,20,8,7,5,40,31,71,B
2015,9826,Female,Pahang,15,6,8,3,32,22,54,C
2018,9827,Female,Malacca,13,8,9,1,31,38,69,B
2012,9828,Female,Malacca,17,10,7,5,39,26,65,B
2015,9829,Male,Negeri Sembilan,17,10,6,5,38,32,70,B
2018,9830,Female,Kedah,16,10,4,2,32,25,57,C
2017,9831,Male,Selangor,19,6,3,2,30,23,53,C
2018,9832,Female,Terengganu,14,3,3,5,25,26,51,C
2018,9833,Female,Penang,17,4,6,3,30,30,60,B
2019,9834,Female,Pahang,19,10,8,5,42,33,75,B
2013,9835,Female,Sarawak,21,7,4,3,35,31,66,B
2015,9836,Female,Selangor,21,10,10,1,42,32,74,B
2013,9837,Male,Perlis,20,3,6,4,33,29,62,B
2012,9838,Male,Selangor,21,7,9,1,38,32,70,B
2015,9839,Female,Sarawak,16,6,6,2,30,39,69,B
2013,9840,Female,Sarawak,21,5,9,2,37,23,60,B
2018,9841,Female,Perak,18,7,6,3,34,26,60,B
2013,9842,Female,Perlis,16,4,9,3,32,36,68,B
2015,9843,Female,Selangor,13,4,9,2,28,38,66,B
2013,9844,Female,Kelantan,20,10,8,2,40,37,77,B
2019,9845,Male,Penang,16,5,9,2,32,37,69,B
2019,9846,Female,Kedah,18,10,4,1,33,38,71,B
2016,9847,Male,Sabah,20,4,10,1,35,28,63,B
2019,9848,Female,Kelantan,21,7,9,1,38,30,68,B
2012,9849,Female,Malacca,13,4,7,2,26,39,65,B
2017,9850,Female,Negeri Sembilan,18,8,8,1,35,30,65,B
2013,9851,Female,Penang,19,7,3,5,34,38,72,B
2014,9852,Male,Terengganu,15,6,3,1,25,38,63,B
2012,9853,Female,Sabah,17,8,5,2,32,38,70,B
2017,9854,Male,Sabah,17,5,7,3,32,30,62,B
2014,9855,Male,Kelantan,13,10,3,3,29,34,63,B
2013,9856,Male,Terengganu,21,5,9,3,38,35,73,B
2016,9857,Male,Sabah,21,10,10,1,42,39,81,A
2018,9858,Female,Pahang,15,10,10,2,37,37,74,B
2015,9859,Male,Selangor,13,9,8,3,33,26,59,C
2019,9860,Male,Negeri Sembilan,18,9,9,4,40,40,80,A
2015,9861,Female,Penang,13,5,6,3,27,40,67,B
2012,9862,Male,Terengganu,19,7,4,4,34,38,72,B
2016,9863,Female,Kedah,17,5,4,4,30,36,66,B
2014,9864,Male,Kedah,20,10,5,1,36,32,68,B
2014,9865,Female,Sarawak,16,7,7,5,35,35,70,B
2012,9866,Male,Pahang,18,8,5,4,35,24,59,C
2012,9867,Male,Kelantan,14,10,8,2,34,32,66,B
2018,9868,Male,Kedah,16,8,8,1,33,22,55,C
2015,9869,Female,Kedah,14,4,6,2,26,38,64,B
2015,9870,Male,Sarawak,17,9,10,2,38,39,77,B
2012,9871,Male,Penang,19,4,3,5,31,36,67,B
2016,9872,Female,Malacca,19,9,10,3,41,22,63,B
2012,9873,Female,Selangor,20,9,6,5,40,34,74,B
2016,9874,Male,Negeri Sembilan,19,4,4,2,29,24,53,C
2018,9875,Female,Penang,21,10,4,2,37,33,70,B
2017,9876,Male,Selangor,14,10,9,4,37,25,62,B
2012,9877,Male,Pahang,20,10,7,2,39,24,63,B
2019,9878,Male,Johor,19,4,6,1,30,22,52,C
2017,9879,Male,Terengganu,17,7,10,5,39,34,73,B
2018,9880,Male,Perlis,14,9,4,5,32,29,61,B
2017,9881,Female,Johor,19,7,8,3,37,22,59,C
2019,9882,Female,Kedah,19,9,9,4,41,23,64,B
2014,9883,Female,Penang,20,3,9,4,36,37,73,B
2016,9884,Female,Sarawak,20,7,6,4,37,29,66,B
2019,9885,Female,Johor,19,7,5,1,32,22,54,C
2015,9886,Male,Terengganu,19,6,9,5,39,33,72,B
2016,9887,Male,Kelantan,20,10,5,2,37,30,67,B
2017,9888,Male,Negeri Sembilan,17,9,4,2,32,30,62,B
2015,9889,Male,Selangor,20,6,8,4,38,31,69,B
2013,9890,Female,Johor,18,6,6,4,34,25,59,C
2013,9891,Female,Penang,17,8,6,4,35,30,65,B
2016,9892,Female,Kedah,18,10,5,3,36,30,66,B
2015,9893,Female,Sarawak,21,4,7,2,34,29,63,B
2016,9894,Male,Kedah,18,10,7,1,36,28,64,B
2018,9895,Male,Kedah,13,9,10,3,35,22,57,C
2012,9896,Female,Kelantan,20,3,9,4,36,26,62,B
2012,9897,Male,Negeri Sembilan,19,7,10,4,40,23,63,B
2016,9898,Male,Perlis,16,8,4,3,31,34,65,B
2016,9899,Female,Malacca,14,10,4,3,31,26,57,C
2017,9900,Female,Sabah,15,4,4,5,28,39,67,B
2019,9901,Female,Terengganu,18,4,8,1,31,29,60,B
2014,9902,Female,Kedah,20,10,9,3,42,37,79,A
2019,9903,Female,Sarawak,15,7,8,5,35,27,62,B
2019,9904,Male,Penang,16,3,5,4,28,37,65,B
2018,9905,Female,Perlis,21,5,8,4,38,30,68,B
2018,9906,Female,Negeri Sembilan,14,10,4,4,32,28,60,B
2013,9907,Female,Perak,17,7,8,1,33,34,67,B
2016,9908,Female,Kelantan,21,7,7,2,37,23,60,B
2015,9909,Male,Sabah,15,5,9,1,30,24,54,C
2012,9910,Male,Malacca,19,8,3,5,35,22,57,C
2013,9911,Male,Pahang,15,7,5,2,29,33,62,B
2016,9912,Male,Penang,15,4,4,1,24,28,52,C
2012,9913,Female,Johor,13,10,9,2,34,27,61,B
2017,9914,Male,Terengganu,19,3,5,3,30,40,70,B
2017,9915,Female,Negeri Sembilan,16,10,3,3,32,33,65,B
2017,9916,Male,Sarawak,19,4,7,5,35,22,57,C
2017,9917,Female,Sarawak,14,7,10,3,34,22,56,C
2015,9918,Male,Perlis,14,4,7,3,28,22,50,C
2013,9919,Female,Malacca,16,9,10,4,39,33,72,B
2018,9920,Male,Perlis,19,5,10,5,39,33,72,B
2017,9921,Male,Kedah,14,8,8,3,33,31,64,B
2012,9922,Male,Johor,15,5,9,2,31,25,56,C
2012,9923,Male,Perak,18,7,6,5,36,32,68,B
2013,9924,Female,Kelantan,14,10,6,1,31,26,57,C
2012,9925,Female,Penang,20,7,4,2,33,26,59,C
2012,9926,Male,Perak,14,3,3,2,22,31,53,C
2015,9927,Male,Malacca,21,5,6,3,35,29,64,B
2012,9928,Female,Penang,21,3,10,4,38,23,61,B
2014,9929,Female,Johor,13,9,6,4,32,40,72,B
2016,9930,Female,Terengganu,20,4,4,1,29,40,69,B
2018,9931,Male,Sarawak,14,10,6,1,31,40,71,B
2018,9932,Female,Johor,13,3,3,1,20,27,47,F
2018,9933,Male,Johor,17,9,9,2,37,22,59,C
2018,9934,Female,Kelantan,21,7,6,2,36,22,58,C
2016,9935,Female,Kelantan,13,9,7,4,33,39,72,B
2014,9936,Male,Kedah,18,3,7,4,32,24,56,C
2015,9937,Female,Kedah,20,7,5,4,36,33,69,B
2013,9938,Female,Sabah,21,6,5,1,33,33,66,B
2017,9939,Female,Malacca,14,5,3,4,26,31,57,C
2018,9940,Male,Terengganu,15,7,9,5,36,22,58,C
2013,9941,Male,Kelantan,15,4,10,1,30,29,59,C
2016,9942,Male,Terengganu,20,6,6,1,33,24,57,C
2015,9943,Female,Kelantan,21,10,8,1,40,32,72,B
2017,9944,Female,Johor,13,5,5,1,24,31,55,C
2014,9945,Female,Malacca,18,7,6,3,34,39,73,B
2016,9946,Female,Johor,20,5,10,1,36,29,65,B
2018,9947,Female,Negeri Sembilan,15,4,9,5,33,24,57,C
2016,9948,Male,Pahang,16,8,7,5,36,26,62,B
2012,9949,Male,Pahang,16,10,6,3,35,33,68,B
2019,9950,Female,Perak,14,3,3,4,24,34,58,C
2016,9951,Male,Terengganu,19,5,8,5,37,37,74,B
2016,9952,Female,Selangor,20,10,9,4,43,38,81,A
2016,9953,Female,Sabah,16,10,5,1,32,37,69,B
2016,9954,Female,Kelantan,20,10,10,3,43,31,74,B
2018,9955,Female,Kedah,20,10,8,2,40,28,68,B
2019,9956,Male,Perak,17,5,4,3,29,40,69,B
2016,9957,Female,Perak,14,4,6,4,28,39,67,B
2013,9958,Male,Selangor,20,7,7,1,35,31,66,B
2019,9959,Female,Perlis,13,7,7,5,32,29,61,B
2018,9960,Female,Perak,18,10,9,1,38,28,66,B
2012,9961,Male,Kedah,21,4,4,4,33,27,60,B
2017,9962,Female,Sarawak,17,7,5,2,31,38,69,B
2017,9963,Male,Malacca,13,6,7,4,30,35,65,B
2017,9964,Female,Kelantan,19,9,4,4,36,36,72,B
2017,9965,Female,Penang,21,10,4,2,37,33,70,B
2013,9966,Male,Malacca,20,9,7,1,37,36,73,B
2015,9967,Female,Penang,14,9,8,5,36,32,68,B
2018,9968,Female,Negeri Sembilan,13,5,5,2,25,36,61,B
2019,9969,Female,Kedah,14,10,4,2,30,23,53,C
2012,9970,Female,Selangor,17,4,3,3,27,37,64,B
2013,9971,Female,Kelantan,17,6,3,2,28,25,53,C
2014,9972,Male,Perak,16,3,6,4,29,25,54,C
2016,9973,Female,Malacca,14,4,8,2,28,28,56,C
2016,9974,Male,Selangor,20,8,6,4,38,32,70,B
2019,9975,Male,Sabah,16,10,10,4,40,25,65,B
2012,9976,Female,Pahang,13,3,6,4,26,31,57,C
2019,9977,Female,Terengganu,15,9,7,5,36,40,76,B
2013,9978,Male,Johor,19,7,9,5,40,34,74,B
2017,9979,Female,Kelantan,17,4,6,4,31,28,59,C
2013,9980,Female,Negeri Sembilan,19,5,6,4,34,28,62,B
2014,9981,Male,Johor,15,10,10,2,37,22,59,C
2019,9982,Female,Perlis,16,5,5,2,28,26,54,C
2014,9983,Female,Perak,16,3,3,5,27,26,53,C
2016,9984,Female,Sabah,18,8,5,2,33,30,63,B
2012,9985,Male,Penang,17,10,6,3,36,39,75,B
2012,9986,Female,Penang,18,7,4,2,31,34,65,B
2018,9987,Female,Johor,16,6,10,3,35,28,63,B
2019,9988,Male,Kelantan,18,6,4,2,30,36,66,B
2018,9989,Male,Sabah,13,6,8,2,29,38,67,B
2014,9990,Female,Kelantan,21,3,10,4,38,24,62,B
2019,9991,Female,Sabah,19,6,9,2,36,37,73,B
2015,9992,Female,Perlis,14,9,7,2,32,26,58,C
2017,9993,Female,Terengganu,16,7,3,2,28,31,59,C
2013,9994,Male,Terengganu,19,5,6,3,33,36,69,B
2018,9995,Female,Negeri Sembilan,14,8,4,5,31,38,69,B
2013,9996,Male,Terengganu,17,4,10,2,33,29,62,B
2019,9997,Female,Sarawak,17,9,7,1,34,27,61,B
2014,9998,Female,Negeri Sembilan,20,9,10,1,40,22,62,B
2013,9999,Female,Kelantan,14,3,8,1,26,28,54,C
2017,10000,Female,Terengganu,19,10,7,1,37,28,65,B
